Team + Rank,Minutes Rank,Player,Class,Pos,School,Conf,G,MP,Totals FG,Totals FGA,Totals 2P,Totals 2PA,Totals 3P,Totals 3PA,Totals FT,Totals FTA,Totals ORB,Totals DRB,Totals TRB,Totals AST,Totals STL,Totals BLK,Totals TOV,Totals PF,Totals PTS
Abilene Christian1,1,Parker Wentz,SR,G,Abilene Christian,Southland,31,918,87,202,18,48,69,154,26,31,5,51,56,27,37,3,27,65,269
Abilene Christian2,2,Jaylen Franklin,FR,G,Abilene Christian,Southland,30,883,176,343,168,315,8,28,126,206,23,92,115,82,52,4,85,84,486
Abilene Christian3,3,Jalen Little,SR,G,Abilene Christian,Southland,26,737,48,125,26,63,22,62,41,49,9,68,77,116,33,2,50,67,159
Abilene Christian4,4,Jaren Lewis,FR,F,Abilene Christian,Southland,31,673,110,218,91,172,19,46,53,73,36,144,180,40,34,18,34,64,292
Abilene Christian5,5,Jovan Crnic,JR,G,Abilene Christian,Southland,31,640,71,192,38,96,33,96,44,55,8,71,79,78,23,3,67,66,219
Abilene Christian6,6,Duran Porter,SR,F,Abilene Christian,Southland,31,615,103,176,103,176,0,0,49,75,38,78,116,18,10,27,44,87,255
Abilene Christian7,7,Austin Cooke,SR,F,Abilene Christian,Southland,30,575,56,149,20,50,36,99,49,59,39,73,112,19,15,2,26,73,197
Abilene Christian8,8,Hayden Howell,FR,F,Abilene Christian,Southland,31,354,42,92,42,92,0,0,35,52,36,31,67,7,5,13,36,56,119
Abilene Christian9,9,Isaiah Tripp,SO,G,Abilene Christian,Southland,29,312,27,56,18,32,9,24,22,27,9,18,27,17,7,0,14,36,85
Abilene Christian10,10,Drake Green,SO,G,Abilene Christian,Southland,29,293,20,80,15,46,5,34,7,10,12,29,41,8,10,5,14,44,52
Abilene Christian11,11,Hayden Farquhar,FR,F,Abilene Christian,Southland,30,250,31,71,23,44,8,27,6,16,14,35,49,10,7,1,17,39,76
Air Force1,1,Hayden Graham,JR,F,Air Force,MWC,31,1112,168,346,133,255,35,91,57,87,49,143,192,69,34,10,63,86,428
Air Force2,2,Zach Kocur,JR,G,Air Force,MWC,32,967,103,265,46,107,57,158,43,60,17,154,171,64,37,0,65,74,306
Air Force3,3,C.J. Siples,SO,G,Air Force,MWC,32,708,71,137,51,95,20,42,45,69,9,84,93,69,29,8,42,69,207
Air Force4,4,Trevor Lyons,SO,G,Air Force,MWC,22,707,83,211,63,153,20,58,93,144,9,69,78,61,31,0,42,42,279
Air Force5,5,Zach Moer,SR,C,Air Force,MWC,29,575,91,198,81,164,10,34,58,77,31,84,115,30,11,24,51,85,250
Air Force6,6,Kyle Broekhuis,JR,F,Air Force,MWC,31,501,33,83,23,50,10,33,27,40,25,63,88,21,6,2,29,49,103
Air Force7,7,Dezmond James,SO,G,Air Force,MWC,32,396,30,95,24,62,6,33,20,34,8,36,44,25,9,1,21,30,86
Air Force8,8,Jacob Van,SO,G,Air Force,MWC,28,395,58,123,40,81,18,42,33,43,7,24,31,27,16,0,27,23,167
Air Force9,9,Frank Toohey,SO,C,Air Force,MWC,26,366,42,81,35,62,7,19,53,73,38,38,76,14,5,6,24,63,144
Air Force10,10,Joe Tuss,JR,F,Air Force,MWC,30,348,29,104,20,61,9,43,14,27,15,43,58,19,6,1,20,44,81
Air Force11,11,Pervis Louder,FR,G,Air Force,MWC,18,210,23,56,18,41,5,15,22,31,13,22,35,9,9,0,17,31,73
Air Force12,12,Ryan Manning,SO,F,Air Force,MWC,5,104,10,33,8,19,2,14,9,9,7,5,12,6,1,4,3,8,31
Air Force13,13,Dane Norman,FR,F,Air Force,MWC,15,45,6,12,5,8,1,4,3,6,3,8,11,1,0,2,1,3,16
Air Force14,14,Daniel Hummer,FR,G,Air Force,MWC,10,38,2,9,0,1,2,8,2,2,1,1,2,4,2,0,3,9,8
Air Force15,15,Jace Chacon,FR,G,Air Force,MWC,4,11,3,4,3,3,0,1,1,1,0,2,2,0,0,0,1,0,7
Akron1,1,Antino Jackson,SO,G,Akron,MAC,34,944,133,349,67,167,66,182,65,78,18,87,105,118,39,1,75,77,397
Akron2,2,Reggie McAdams,SR,F,Akron,MAC,34,894,121,278,26,53,95,225,51,71,31,99,130,28,23,9,25,65,388
Akron3,3,Noah Robotham,SO,G,Akron,MAC,28,889,89,211,34,77,55,134,42,56,12,64,76,107,33,3,41,50,275
Akron4,4,Isaiah Johnson,JR,C,Akron,MAC,34,851,169,291,168,286,1,5,121,196,89,165,254,56,16,44,52,81,460
Akron5,5,Jake Kretzer,SR,G,Akron,MAC,33,819,86,201,16,32,70,169,27,31,35,101,136,43,18,3,19,74,269
Akron6,6,Kwan Cheatham,JR,F,Akron,MAC,34,761,86,231,48,119,38,112,41,62,42,127,169,55,8,32,45,88,251
Akron7,7,Josh Williams,FR,G,Akron,MAC,33,619,72,177,14,41,58,136,20,26,16,67,83,44,14,4,48,42,222
Akron8,8,Pat Forsythe,SR,C,Akron,MAC,22,433,76,157,76,156,0,1,38,57,36,71,107,13,16,31,33,51,190
Akron9,9,Aaron Jackson,SO,G,Akron,MAC,28,279,26,65,15,29,11,36,19,27,15,18,33,11,6,3,10,40,82
Akron10,10,Jimond Ivey,SO,G,Akron,MAC,31,270,28,71,23,48,5,23,19,33,11,41,52,21,8,3,17,29,80
Akron11,11,Mark Noble,JR,G,Akron,MAC,5,14,1,3,1,2,0,1,0,0,0,1,1,0,1,0,2,2,2
Akron12,12,Carlitos Anderson,FR,G,Akron,MAC,5,13,1,1,0,0,1,1,0,0,0,3,3,1,1,0,0,0,3
Alabama1,1,Retin Obasohan,SR,G,Alabama,SEC,32,1036,190,400,143,275,47,125,140,203,19,104,123,83,44,10,80,84,567
Alabama2,2,Arthur Edwards,SR,G,Alabama,SEC,32,918,106,250,35,76,71,174,27,40,18,103,121,45,22,15,61,82,310
Alabama3,3,Riley Norris,SO,F,Alabama,SEC,32,897,76,203,32,86,44,117,47,72,52,121,173,23,26,8,38,61,243
Alabama4,4,Justin Coleman,SO,G,Alabama,SEC,32,840,67,228,31,90,36,138,71,80,7,56,63,108,23,0,62,45,241
Alabama5,5,Jimmie Taylor,JR,F,Alabama,SEC,32,678,67,116,67,116,0,0,36,97,52,99,151,13,15,58,40,84,170
Alabama6,6,Shannon Hale,JR,F,Alabama,SEC,27,664,93,248,52,124,41,124,65,87,22,56,78,14,12,7,56,62,292
Alabama7,7,Michael Kessens,JR,F,Alabama,SEC,32,537,47,83,46,79,1,4,25,46,49,65,114,18,14,13,29,75,120
Alabama8,8,Donta Hall,FR,F,Alabama,SEC,32,401,35,56,35,56,0,0,18,42,41,93,134,7,12,50,15,81,88
Alabama9,9,Brandon Austin,FR,G,Alabama,SEC,29,256,18,58,10,19,8,39,2,4,7,18,25,2,3,4,6,16,46
Alabama10,10,Dazon Ingram,FR,G,Alabama,SEC,7,179,20,37,19,35,1,2,13,22,6,35,41,23,8,3,24,23,54
Alabama11,11,Lawson Schaffer,FR,G,Alabama,SEC,14,31,2,10,0,1,2,9,2,4,2,0,2,2,1,0,1,3,8
Alabama A&M1,1,Ladarius Tabb,SR,G,Alabama A&M,SWAC,29,1000,201,457,156,304,45,153,102,160,58,143,201,21,41,8,50,73,549
Alabama A&M2,2,Nicholas West,SR,F,Alabama A&M,SWAC,29,878,132,286,114,222,18,64,123,170,73,154,227,43,17,27,71,95,405
Alabama A&M3,3,Rakiya Battle,JR,G,Alabama A&M,SWAC,29,756,50,155,33,95,17,60,66,84,16,54,70,153,25,2,59,40,183
Alabama A&M4,4,Arthur Wade,SR,G,Alabama A&M,SWAC,29,625,37,103,19,41,18,62,22,32,22,33,55,29,25,8,20,82,114
Alabama A&M5,5,Christopher Thomas,JR,G,Alabama A&M,SWAC,28,480,49,113,35,59,14,54,14,23,25,45,70,14,5,2,13,37,126
Alabama A&M6,6,Jacob Perry,SR,G,Alabama A&M,SWAC,27,431,50,127,31,59,19,68,54,77,8,21,29,43,8,0,35,52,173
Alabama A&M7,7,Adrian Edwards,JR,F,Alabama A&M,SWAC,29,362,32,92,32,89,0,3,11,17,31,43,74,12,9,3,14,55,75
Alabama A&M8,8,Quinterian McConico,JR,C,Alabama A&M,SWAC,18,325,53,83,52,82,1,1,15,21,16,50,66,5,3,8,14,37,122
Alabama A&M9,9,Tyler Davis,SR,G,Alabama A&M,SWAC,21,275,16,50,5,8,11,42,4,7,9,9,18,7,10,0,7,19,47
Alabama A&M10,10,Rashawn Green,FR,G,Alabama A&M,SWAC,19,248,30,72,8,15,22,57,3,6,3,15,18,9,5,0,9,26,85
Alabama A&M11,11,Matthew Cotton,SR,G,Alabama A&M,SWAC,26,186,12,33,7,17,5,16,15,20,8,14,22,20,4,0,15,11,44
Alabama A&M12,12,Zachary Jackson,FR,G,Alabama A&M,SWAC,22,158,13,37,11,26,2,11,5,13,9,10,19,5,7,2,6,18,33
Alabama A&M13,13,Baryn Houston,SR,G,Alabama A&M,SWAC,14,78,4,14,1,6,3,8,0,1,1,9,10,4,3,0,3,8,11
Alabama A&M14,14,Mohamed Sherif,FR,F,Alabama A&M,SWAC,13,72,2,10,2,10,0,0,5,11,3,10,13,1,1,1,9,8,9
Alabama State1,1,Jamel Waters,SR,G,Alabama State,SWAC,31,1057,160,390,84,206,76,184,98,134,32,102,134,134,54,2,81,65,494
Alabama State2,2,Torloft Thomas,JR,G,Alabama State,SWAC,31,838,70,187,33,82,37,105,72,96,20,56,76,58,21,3,64,69,249
Alabama State3,3,Bobby Brown,SR,G,Alabama State,SWAC,31,792,105,298,74,181,31,117,32,47,48,131,179,18,18,14,42,54,273
Alabama State4,4,Steve Rogers,SO,G,Alabama State,SWAC,31,749,65,208,35,96,30,112,43,57,19,35,54,33,19,5,28,65,203
Alabama State5,5,Corvon Butler,JR,F,Alabama State,SWAC,31,693,128,230,127,222,1,8,42,62,70,116,186,29,20,19,33,94,299
Alabama State6,6,Terrance LeFlore,SO,G,Alabama State,SWAC,31,597,65,194,36,117,29,77,42,58,14,42,56,57,19,3,45,61,201
Alabama State7,7,Tony Armstrong,JR,F,Alabama State,SWAC,21,561,97,202,97,202,0,0,59,93,36,89,125,16,12,23,24,74,253
Alabama State8,8,Chidozie Omile,SR,G,Alabama State,SWAC,25,305,28,89,21,58,7,31,11,22,15,36,51,13,9,6,19,40,74
Alabama State9,9,Glenn Hollaway,SO,F,Alabama State,SWAC,25,297,25,39,25,38,0,1,5,11,26,35,61,8,3,20,5,41,55
Alabama State10,10,Mikel Tyson,FR,F,Alabama State,SWAC,25,258,34,54,34,54,0,0,19,32,30,44,74,4,4,11,18,49,87
Alabama State11,11,Robert Ojeah,SR,C,Alabama State,SWAC,13,81,6,12,6,12,0,0,3,9,9,13,22,1,0,1,4,22,15
Alabama State12,12,Nicholas Barnes,JR,G,Alabama State,SWAC,8,57,4,13,0,2,4,11,0,2,2,0,2,0,1,0,3,6,12
Alabama State13,13,Joseff Smith,FR,G,Alabama State,SWAC,8,9,1,1,1,1,0,0,0,0,0,0,0,0,1,0,1,3,2
Alabama-Birmingham1,1,Robert Brown,SR,G,Alabama-Birmingham,CUSA,32,968,152,356,90,196,62,160,68,90,10,76,86,100,29,9,54,55,434
Alabama-Birmingham2,2,Nick Norton,SO,G,Alabama-Birmingham,CUSA,31,848,86,205,29,51,57,154,49,57,9,75,84,159,52,1,51,52,278
Alabama-Birmingham3,3,William Lee,SO,F,Alabama-Birmingham,CUSA,32,796,134,271,103,181,31,90,42,65,54,147,201,49,23,92,51,52,341
Alabama-Birmingham4,4,Hakeem Baxter,JR,G,Alabama-Birmingham,CUSA,32,783,61,155,52,123,9,32,60,82,20,74,94,66,16,9,47,55,191
Alabama-Birmingham5,5,Chris Cokley,SO,F,Alabama-Birmingham,CUSA,32,706,171,298,171,298,0,0,78,109,74,132,206,45,26,21,33,89,420
Alabama-Birmingham6,6,Tosin Mehinti,JR,F,Alabama-Birmingham,CUSA,31,634,72,129,72,129,0,0,40,76,58,89,147,35,15,31,46,89,184
Alabama-Birmingham7,7,Dirk Williams,JR,G,Alabama-Birmingham,CUSA,32,606,105,216,60,98,45,118,43,47,36,89,125,43,14,16,35,47,298
Alabama-Birmingham8,8,Denzell Watts,JR,G,Alabama-Birmingham,CUSA,32,483,44,109,19,43,25,66,18,25,2,49,51,55,16,1,37,36,131
Alabama-Birmingham9,9,Lewis Sullivan,SO,F,Alabama-Birmingham,CUSA,32,388,56,91,55,87,1,4,39,59,27,52,79,22,11,10,22,48,152
Alabama-Birmingham10,10,Tyler Madison,JR,G,Alabama-Birmingham,CUSA,31,221,20,54,19,50,1,4,13,19,18,15,33,14,5,3,16,33,54
Alabama-Birmingham11,11,Thomas Smallwood,FR,F,Alabama-Birmingham,CUSA,9,46,14,24,8,12,6,12,5,6,4,15,19,2,0,3,0,9,39
Alabama-Birmingham12,12,Lionel Love,SO,G,Alabama-Birmingham,CUSA,9,21,1,2,0,0,1,2,2,2,0,3,3,0,0,0,0,1,5
Albany (NY)1,1,Evan Singletary,SR,G,Albany (NY),AEC,32,1057,133,327,85,189,48,138,94,127,15,98,113,96,39,7,70,74,408
Albany (NY)2,2,Peter Hooley,SR,G,Albany (NY),AEC,32,1049,127,335,89,176,38,159,111,146,18,127,145,88,31,4,72,32,403
Albany (NY)3,3,Mike Rowley,JR,F,Albany (NY),AEC,32,918,96,167,96,166,0,1,66,91,83,122,205,34,33,11,53,89,258
Albany (NY)4,4,Ray Sanders,SR,G,Albany (NY),AEC,32,872,129,289,90,184,39,105,87,113,32,104,136,76,51,3,55,88,384
Albany (NY)5,5,Greig Stire,SO,F,Albany (NY),AEC,31,716,88,157,88,157,0,0,62,97,88,98,186,23,14,4,32,97,238
Albany (NY)6,6,Joe Cremo,FR,G,Albany (NY),AEC,32,665,103,199,85,156,18,43,110,128,30,89,119,45,22,6,43,40,334
Albany (NY)7,7,Dallas Ennema,JR,F,Albany (NY),AEC,31,456,48,121,23,47,25,74,16,23,16,61,77,13,9,6,14,45,137
Albany (NY)8,8,Richard Peters,JR,C,Albany (NY),AEC,30,360,36,62,36,62,0,0,13,22,34,59,93,7,5,8,26,48,85
Albany (NY)9,9,Jamir Andrews,JR,G,Albany (NY),AEC,23,160,19,56,9,21,10,35,23,25,2,15,17,8,7,0,13,19,71
Albany (NY)10,10,Travis Charles,JR,F,Albany (NY),AEC,9,127,21,36,21,36,0,0,9,16,8,15,23,2,1,2,6,20,51
Albany (NY)11,11,David Nichols,FR,G,Albany (NY),AEC,14,71,12,21,10,15,2,6,10,15,0,7,7,7,0,1,8,8,36
Alcorn State1,1,Tamarcio Wilson,SR,G,Alcorn State,SWAC,29,903,121,299,83,170,38,129,75,104,12,77,89,51,19,2,81,42,355
Alcorn State2,2,Marquis Vance,JR,F,Alcorn State,SWAC,30,892,75,222,46,132,29,90,59,98,44,118,162,56,13,17,60,58,238
Alcorn State3,3,Devonte Hampton,SR,G,Alcorn State,SWAC,27,800,80,223,43,106,37,117,36,53,15,85,100,63,28,6,59,79,233
Alcorn State4,4,Patrick Onwenu,SR,F,Alcorn State,SWAC,29,727,70,146,70,138,0,8,95,130,48,68,116,24,10,30,52,80,235
Alcorn State5,5,Octavius Brown,SR,F,Alcorn State,SWAC,21,651,99,207,71,136,28,71,47,62,36,111,147,19,16,28,38,50,273
Alcorn State6,6,Deandre Davis,JR,F,Alcorn State,SWAC,30,553,90,154,84,139,6,15,36,59,76,58,134,8,14,21,32,90,222
Alcorn State7,7,Reginald Johnson,SO,F,Alcorn State,SWAC,30,516,82,184,69,144,13,40,27,41,39,44,83,14,6,3,25,32,204
Alcorn State8,8,Tyrel Hunt,SR,F,Alcorn State,SWAC,29,425,29,77,25,65,4,12,43,61,19,35,54,16,10,2,25,36,105
Alcorn State9,9,Rahamanh Katumbusi II,FR,G,Alcorn State,SWAC,27,258,19,69,8,35,11,34,18,25,1,12,13,4,10,0,18,20,67
Alcorn State10,10,Malachy Onwudiegwu,JR,G,Alcorn State,SWAC,25,234,13,57,7,28,6,29,11,23,9,9,18,5,3,1,18,25,43
Alcorn State11,11,Shawn Willett,FR,G,Alcorn State,SWAC,18,104,6,31,5,19,1,12,6,12,10,4,14,7,4,0,10,18,19
Alcorn State12,12,Juwan Henderson,SO,G,Alcorn State,SWAC,5,49,3,13,2,5,1,8,2,4,1,7,8,4,1,0,5,10,9
Alcorn State13,13,TyQuayion Smith,FR,F,Alcorn State,SWAC,13,40,4,8,4,8,0,0,3,4,1,0,1,1,0,1,1,8,11
American1,1,Jesse Reed,SR,G,American,Patriot,31,1173,137,309,83,173,54,136,73,99,20,121,141,65,29,18,75,77,401
American2,2,Delante Jones,FR,F,American,Patriot,30,997,116,272,77,166,39,106,90,129,26,81,107,53,22,6,79,82,361
American3,3,Marko Vasic,SR,F,American,Patriot,31,787,50,120,43,91,7,29,21,29,27,110,137,68,27,6,36,68,128
American4,4,James Washington,FR,G,American,Patriot,31,784,73,210,43,104,30,106,22,34,6,46,52,33,23,2,49,65,198
American5,5,Charlie Jones,JR,F,American,Patriot,31,673,49,96,34,63,15,33,34,48,13,90,103,38,34,16,30,50,147
American6,6,Paris Maragkos,JR,C,American,Patriot,31,463,90,180,81,163,9,17,30,43,19,51,70,28,12,5,54,67,219
American7,7,Andrija Matic,FR,F,American,Patriot,30,438,42,96,33,66,9,30,23,36,27,37,64,26,4,9,45,59,116
American8,8,Jalen Rhea,JR,G,American,Patriot,22,366,29,86,7,21,22,65,14,21,14,13,27,9,11,0,9,35,94
American9,9,Lonnie Rivera,FR,F,American,Patriot,22,227,16,42,15,34,1,8,14,18,10,26,36,10,3,1,19,20,47
American10,10,Leon Tolksdorf,JR,F,American,Patriot,22,221,16,50,8,15,8,35,3,7,12,24,36,14,9,5,3,24,43
American11,11,Alex Paquin,SO,G,American,Patriot,14,107,10,22,9,15,1,7,4,6,0,10,10,2,2,0,5,16,25
American12,12,Gabe Brown,SO,C,American,Patriot,3,17,3,4,3,4,0,0,0,1,1,0,1,2,0,1,4,3,6
Appalachian State1,1,Frank Eaves,SR,G,Appalachian State,Sun Belt,31,965,170,446,87,230,83,216,156,191,20,96,116,68,26,1,70,71,579
Appalachian State2,2,Ronshad Shabazz,FR,G,Appalachian State,Sun Belt,31,786,127,320,83,200,44,120,72,107,32,80,112,47,20,2,65,48,370
Appalachian State3,3,Chris Burgess,SR,G,Appalachian State,Sun Belt,31,653,70,170,25,52,45,118,30,37,10,26,36,68,14,0,27,60,215
Appalachian State4,4,Griffin Kinney,SO,F,Appalachian State,Sun Belt,31,581,72,152,72,150,0,2,50,75,43,102,145,26,14,2,53,82,194
Appalachian State5,5,Emarius Logan,FR,G,Appalachian State,Sun Belt,31,578,58,159,35,93,23,66,38,48,18,42,60,38,7,2,56,33,177
Appalachian State6,6,Tyrell Johnson,FR,F,Appalachian State,Sun Belt,30,520,45,114,42,100,3,14,24,45,41,82,123,8,14,21,40,66,117
Appalachian State7,7,Michael Obacha,SR,F,Appalachian State,Sun Belt,30,508,31,54,31,54,0,0,38,70,55,55,110,11,8,11,29,80,100
Appalachian State8,8,Jacob Lawson,SR,F,Appalachian State,Sun Belt,31,479,61,115,61,115,0,0,42,56,36,75,111,20,13,54,31,93,164
Appalachian State9,9,Matt O'Boyle,JR,G,Appalachian State,Sun Belt,31,371,30,95,9,20,21,75,12,25,22,47,69,13,3,3,16,41,93
Appalachian State10,10,Jake Babic,SO,G,Appalachian State,Sun Belt,31,359,19,75,4,28,15,47,10,17,10,34,44,44,5,3,30,38,63
Appalachian State11,11,Bennett Holley,FR,F,Appalachian State,Sun Belt,25,232,23,54,6,11,17,43,11,14,9,19,28,7,0,2,9,34,74
Appalachian State12,12,Dustin Clarke,SR,G,Appalachian State,Sun Belt,18,98,8,27,5,11,3,16,4,4,5,14,19,6,3,1,6,5,23
Appalachian State13,13,Mike Kobani,JR,F,Appalachian State,Sun Belt,6,26,1,3,1,3,0,0,0,0,5,3,8,0,0,0,4,8,2
Appalachian State14,14,Landon Goesling,SO,G,Appalachian State,Sun Belt,3,20,2,5,2,4,0,1,3,6,0,3,3,0,0,0,2,2,7
Appalachian State15,15,Dylan Hodson,SO,G,Appalachian State,Sun Belt,4,7,1,4,0,3,1,1,0,0,1,3,4,0,0,0,0,0,3
Appalachian State16,16,Trey Ford,FR,G,Appalachian State,Sun Belt,1,1,1,1,0,0,1,1,0,0,0,0,0,0,0,0,0,1,3
Arizona1,1,Gabe York,SR,G,Arizona,Pac-12,33,1099,174,410,78,184,96,226,57,76,19,89,108,76,30,9,69,66,501
Arizona2,2,Ryan Anderson,SR,F,Arizona,Pac-12,32,932,170,311,168,304,2,7,155,208,99,224,323,25,22,20,61,68,497
Arizona3,3,Kadeem Allen,JR,G,Arizona,Pac-12,33,817,96,208,79,159,17,49,65,92,8,92,100,119,34,27,61,78,274
Arizona4,4,Mark Tollefsen,SR,F,Arizona,Pac-12,33,737,90,173,64,101,26,72,31,38,42,60,102,44,13,20,18,64,237
Arizona5,5,Allonzo Trier,FR,G,Arizona,Pac-12,26,730,118,250,80,146,38,104,115,145,11,76,87,29,14,6,48,48,389
Arizona6,6,Parker Jackson-Cartwright,SO,G,Arizona,Pac-12,33,702,55,137,29,68,26,69,36,55,9,45,54,115,21,7,48,71,172
Arizona7,7,Kaleb Tarczewski,SR,C,Arizona,Pac-12,25,677,78,147,78,147,0,0,80,111,63,169,232,15,7,33,32,73,236
Arizona8,8,Dusan Ristic,SO,C,Arizona,Pac-12,33,552,93,170,90,162,3,8,52,82,47,80,127,27,5,23,41,65,241
Arizona9,9,Justin Simon,FR,G,Arizona,Pac-12,24,180,23,46,22,43,1,3,9,21,7,22,29,8,7,6,14,22,56
Arizona10,10,Elliott Pitts,JR,G,Arizona,Pac-12,7,149,7,26,5,10,2,16,0,2,8,8,16,13,8,0,11,21,16
Arizona11,11,Chance Comanche,FR,C,Arizona,Pac-12,22,133,16,32,16,32,0,0,11,16,12,23,35,5,1,7,8,17,43
Arizona12,12,Jacob Hazzard,SR,G,Arizona,Pac-12,7,26,6,10,2,4,4,6,2,2,0,1,1,2,0,0,1,4,18
Arizona State1,1,Tra Holder,SO,G,Arizona State,Pac-12,32,1017,140,362,91,228,49,134,125,172,22,90,112,117,33,2,84,66,454
Arizona State2,2,Gerry Blakes,SR,G,Arizona State,Pac-12,32,962,128,332,81,181,47,151,50,69,34,136,170,76,34,5,66,94,353
Arizona State3,3,Willie Atwood,SR,F,Arizona State,Pac-12,32,866,78,196,46,94,32,102,80,102,50,89,139,44,15,9,30,97,268
Arizona State4,4,Kodi Justice,SO,G,Arizona State,Pac-12,32,792,84,213,24,63,60,150,25,33,12,57,69,76,30,5,53,78,253
Arizona State5,5,Obinna Oleka,JR,F,Arizona State,Pac-12,32,792,104,263,77,177,27,86,73,94,63,132,195,22,22,17,43,67,308
Arizona State6,6,Eric Jacobsen,SR,F,Arizona State,Pac-12,32,722,91,158,90,156,1,2,62,97,72,91,163,16,6,31,29,101,245
Arizona State7,7,Savon Goodman,JR,F,Arizona State,Pac-12,28,588,105,191,105,187,0,4,58,126,61,119,180,15,16,15,40,87,268
Arizona State8,8,Andre Spight,JR,G,Arizona State,Pac-12,27,526,60,177,24,63,36,114,23,29,7,17,24,34,13,0,20,42,179
Arizona State9,9,Maurice O'Field,SO,G,Arizona State,Pac-12,23,148,5,21,4,12,1,9,1,2,5,13,18,4,1,1,7,14,12
Arizona State10,10,Austin Witherill,SO,G,Arizona State,Pac-12,13,18,1,6,0,1,1,5,2,2,0,0,0,0,0,0,1,0,5
Arkansas1,1,Moses Kingsley,SO,F,Arkansas,SEC,32,945,183,334,183,334,0,0,142,223,103,196,299,39,36,76,65,94,508
Arkansas2,2,Anthlon Bell,SR,G,Arkansas,SEC,32,917,172,402,83,200,89,202,69,82,22,71,93,39,20,7,35,70,502
Arkansas3,3,Jabril Durham,SR,G,Arkansas,SEC,32,891,59,168,40,101,19,67,61,77,15,96,111,204,53,2,58,70,198
Arkansas4,4,Dusty Hannahs,JR,G,Arkansas,SEC,32,866,174,380,93,193,81,187,100,115,19,58,77,29,20,0,41,68,529
Arkansas5,5,Manuale Watkins,JR,G,Arkansas,SEC,32,629,69,145,69,144,0,1,25,46,29,67,96,66,25,3,24,55,163
Arkansas6,6,Jimmy Whitt,FR,G,Arkansas,SEC,32,550,75,194,69,178,6,16,38,48,11,42,53,34,20,6,31,66,194
Arkansas7,7,Trey Thompson,SO,F,Arkansas,SEC,29,503,37,61,37,61,0,0,16,31,28,96,124,36,13,27,32,88,90
Arkansas8,8,Anton Beard,SO,G,Arkansas,SEC,23,481,57,164,38,98,19,66,27,42,13,40,53,40,23,2,17,53,160
Arkansas9,9,Keaton Miles,SR,F,Arkansas,SEC,32,480,35,103,34,99,1,4,21,48,35,56,91,29,20,23,34,82,92
Arkansas10,10,Willy Kouassi,SR,C,Arkansas,SEC,31,255,21,36,21,36,0,0,20,36,25,35,60,1,3,19,10,41,62
Arkansas11,11,Lorenzo Jenkins,FR,G,Arkansas,SEC,1,7,1,4,0,3,1,1,0,0,0,2,2,1,0,0,0,0,3
Arkansas State1,1,Devin Carter,JR,G,Arkansas State,Sun Belt,31,1110,183,400,95,189,88,211,82,117,30,105,135,60,22,10,56,86,536
Arkansas State2,2,Sean Gardner,SR,G,Arkansas State,Sun Belt,30,972,106,305,68,175,38,130,61,73,42,65,107,51,27,7,52,66,311
Arkansas State3,3,Anthony Livingston,JR,F,Arkansas State,Sun Belt,31,961,168,390,146,306,22,84,122,142,80,210,290,15,19,25,54,90,480
Arkansas State4,4,Donte Thomas,JR,G,Arkansas State,Sun Belt,26,828,88,192,83,168,5,24,110,164,22,129,151,146,31,7,76,71,291
Arkansas State5,5,Frederic Dure,SR,G,Arkansas State,Sun Belt,30,693,45,139,30,78,15,61,65,97,10,85,95,57,17,19,52,68,170
Arkansas State6,6,Nouhoum Bocoum,SR,C,Arkansas State,Sun Belt,29,431,76,158,76,156,0,2,53,76,45,74,119,11,2,20,29,40,205
Arkansas State7,7,Charles Waters,SR,F,Arkansas State,Sun Belt,31,424,51,128,51,127,0,1,29,40,35,80,115,11,17,33,26,85,131
Arkansas State8,8,Josh Pierre,SR,G,Arkansas State,Sun Belt,24,286,5,36,0,5,5,31,7,10,5,24,29,4,5,1,4,17,22
Arkansas State9,9,Christian Davis,FR,F,Arkansas State,Sun Belt,28,234,12,46,12,43,0,3,18,28,8,30,38,1,4,6,19,47,42
Arkansas State10,10,P.J. Hardwick,JR,G,Arkansas State,Sun Belt,7,142,4,18,3,15,1,3,8,12,3,14,17,19,7,0,10,12,17
Arkansas State11,11,Kelvin Downs,SR,F,Arkansas State,Sun Belt,10,134,22,35,22,35,0,0,7,7,6,21,27,4,3,8,11,18,51
Arkansas State12,12,Connor Kern,FR,G,Arkansas State,Sun Belt,8,87,10,26,4,6,6,20,0,0,1,5,6,2,3,0,4,13,26
Arkansas-Little Rock1,1,Josh Hagins,SR,G,Arkansas-Little Rock,Sun Belt,33,998,149,330,97,192,52,138,74,88,25,109,134,155,46,6,58,72,424
Arkansas-Little Rock2,2,Marcus Johnson Jr.,JR,G,Arkansas-Little Rock,Sun Belt,33,992,134,281,63,127,71,154,80,99,19,79,98,54,24,0,46,36,419
Arkansas-Little Rock3,3,Lis Shoshi,JR,F,Arkansas-Little Rock,Sun Belt,33,743,93,191,82,160,11,31,29,47,54,122,176,27,7,38,28,91,226
Arkansas-Little Rock4,4,Roger Woods,SR,F,Arkansas-Little Rock,Sun Belt,33,725,115,207,105,179,10,28,84,131,39,97,136,53,31,8,47,68,324
Arkansas-Little Rock5,5,Jermaine Ruttley,SR,G,Arkansas-Little Rock,Sun Belt,33,624,40,107,33,73,7,34,26,33,17,85,102,54,19,1,24,62,113
Arkansas-Little Rock6,6,Mareik Isom,JR,F,Arkansas-Little Rock,Sun Belt,32,611,64,148,23,51,41,97,29,37,23,64,87,13,11,16,14,86,198
Arkansas-Little Rock7,7,Kemy Osse,JR,G,Arkansas-Little Rock,Sun Belt,33,528,58,158,17,52,41,106,11,18,12,53,65,27,32,7,14,37,168
Arkansas-Little Rock8,8,Jalen Jackson,JR,G,Arkansas-Little Rock,Sun Belt,31,485,111,221,105,206,6,15,48,66,26,40,66,22,17,9,45,50,276
Arkansas-Little Rock9,9,Maurius Hill,JR,F,Arkansas-Little Rock,Sun Belt,33,439,41,95,35,80,6,15,20,26,31,68,99,12,14,5,33,32,108
Arkansas-Little Rock10,10,Stetson Billings,JR,F,Arkansas-Little Rock,Sun Belt,28,219,7,30,6,25,1,5,3,6,11,20,31,10,5,5,8,34,18
Arkansas-Little Rock11,11,Daniel Green,SR,F,Arkansas-Little Rock,Sun Belt,20,138,9,23,9,21,0,2,6,11,12,21,33,2,3,7,7,28,24
Arkansas-Little Rock12,12,Deondre Burns,FR,G,Arkansas-Little Rock,Sun Belt,17,93,9,24,8,14,1,10,10,10,0,10,10,3,6,1,5,7,29
Arkansas-Little Rock13,13,Ben Marcus,FR,G,Arkansas-Little Rock,Sun Belt,9,16,4,6,4,6,0,0,0,0,0,2,2,0,1,2,1,1,8
Arkansas-Little Rock14,14,Evan Moorman,JR,G,Arkansas-Little Rock,Sun Belt,3,12,2,6,0,0,2,6,0,0,0,0,0,1,0,0,0,0,6
Arkansas-Pine Bluff1,1,Ghiavonni Robinson,JR,G,Arkansas-Pine Bluff,SWAC,33,1044,126,383,64,154,62,229,52,83,23,83,106,67,46,3,82,75,366
Arkansas-Pine Bluff2,2,Jovaughn Love,SR,F,Arkansas-Pine Bluff,SWAC,33,900,105,307,80,212,25,95,62,95,28,114,142,35,20,13,52,67,297
Arkansas-Pine Bluff3,3,Trent Whiting,SR,F,Arkansas-Pine Bluff,SWAC,33,696,66,146,55,109,11,37,29,46,32,59,91,51,23,16,45,53,172
Arkansas-Pine Bluff4,4,Marcus Wallace,FR,G,Arkansas-Pine Bluff,SWAC,31,664,48,129,25,55,23,74,22,31,17,31,48,24,24,0,47,35,141
Arkansas-Pine Bluff5,5,Charles Jackson,FR,G,Arkansas-Pine Bluff,SWAC,33,586,71,168,36,64,35,104,29,43,20,38,58,32,22,5,56,85,206
Arkansas-Pine Bluff6,6,Marquis Cunningham,JR,C,Arkansas-Pine Bluff,SWAC,33,507,74,156,74,154,0,2,49,76,33,71,104,19,15,34,36,95,197
Arkansas-Pine Bluff7,7,Devin Berry,JR,F,Arkansas-Pine Bluff,SWAC,28,365,34,79,34,79,0,0,27,53,44,44,88,13,9,11,37,74,95
Arkansas-Pine Bluff8,8,Thaddeus Handley,SR,F,Arkansas-Pine Bluff,SWAC,22,334,50,112,38,80,12,32,13,21,18,51,69,8,17,3,34,37,125
Arkansas-Pine Bluff9,9,Chauncy Parker,SR,C,Arkansas-Pine Bluff,SWAC,32,277,12,19,12,19,0,0,4,12,11,26,37,16,8,24,23,67,28
Arkansas-Pine Bluff10,10,Austin Cox,SO,G,Arkansas-Pine Bluff,SWAC,28,275,22,46,14,26,8,20,6,11,12,38,50,9,15,2,18,22,58
Arkansas-Pine Bluff11,11,Deshon Bayless,JR,F,Arkansas-Pine Bluff,SWAC,15,273,25,70,17,47,8,23,14,24,9,21,30,9,12,0,14,48,72
Arkansas-Pine Bluff12,12,Jaquan Lynch,JR,G,Arkansas-Pine Bluff,SWAC,17,269,24,68,7,23,17,45,9,10,7,16,23,18,11,0,15,9,74
Arkansas-Pine Bluff13,13,J'Breun Sprinkle,FR,G,Arkansas-Pine Bluff,SWAC,18,191,8,14,7,12,1,2,1,4,5,6,11,9,10,0,16,11,18
Arkansas-Pine Bluff14,14,David Tillman,JR,C,Arkansas-Pine Bluff,SWAC,24,144,6,14,6,14,0,0,0,7,3,7,10,4,1,12,9,28,12
Arkansas-Pine Bluff15,15,Larry Johnson,SR,G,Arkansas-Pine Bluff,SWAC,25,99,3,11,3,8,0,3,0,3,4,4,8,3,2,0,12,17,6
Army1,1,Kyle Wilson,SR,F,Army,Patriot,32,1039,172,455,73,164,99,291,70,86,10,63,73,53,12,9,57,56,513
Army2,2,Tanner Plomb,SR,F,Army,Patriot,27,845,182,427,106,211,76,216,95,129,17,142,159,42,25,7,47,46,535
Army3,3,Dylan Cox,SR,G,Army,Patriot,30,837,90,178,85,161,5,17,58,85,37,96,133,143,23,15,73,71,243
Army4,4,Larry Toomey,SR,F,Army,Patriot,32,793,59,154,36,83,23,71,47,65,43,140,183,68,14,10,35,75,188
Army5,5,Kevin Ferguson,SR,C,Army,Patriot,28,774,150,242,150,242,0,0,72,104,110,161,271,31,14,43,53,83,372
Army6,6,Kennedy Edwards,JR,F,Army,Patriot,30,432,54,133,41,86,13,47,20,37,40,61,101,17,16,12,24,50,141
Army7,7,Jordan Fox,FR,G,Army,Patriot,32,389,30,72,23,48,7,24,17,21,7,28,35,71,15,2,38,45,84
Army8,8,John Emezie,FR,G,Army,Patriot,32,372,33,86,25,54,8,32,26,48,15,22,37,20,5,8,29,53,100
Army9,9,Mac Hoffman,JR,F,Army,Patriot,25,295,13,32,12,29,1,3,11,16,24,45,69,13,5,4,13,50,38
Army10,10,Adam Roe,FR,F,Army,Patriot,32,292,34,97,9,30,25,67,13,21,16,23,39,11,8,2,14,31,106
Army11,11,Luke Morrison,SO,F,Army,Patriot,20,205,34,94,16,44,18,50,7,7,20,21,41,5,12,0,18,29,93
Army12,12,Scott Mammel,JR,G,Army,Patriot,12,70,4,14,3,8,1,6,6,6,2,7,9,9,2,0,6,7,15
Army13,13,Nathan Dodge,SO,G,Army,Patriot,8,57,8,18,1,3,7,15,1,1,0,4,4,1,3,0,3,5,24
Army14,14,Cayne Edwards,FR,G,Army,Patriot,8,40,3,6,2,3,1,3,5,8,2,10,12,3,1,1,4,4,12
Army15,15,John Miller,FR,C,Army,Patriot,5,21,1,2,1,2,0,0,0,4,2,3,5,0,2,1,0,1,2
Army16,16,Maxwell Lenox,SR,G,Army,Patriot,3,10,3,4,3,3,0,1,0,3,0,7,7,0,1,2,0,0,6
Auburn1,1,Tyler Harris,SR,F,Auburn,SEC,30,855,141,312,132,276,9,36,127,194,84,146,230,40,21,14,76,99,418
Auburn2,2,Cinmeon Bowers,SR,F,Auburn,SEC,30,854,104,282,89,221,15,61,92,170,64,225,289,47,29,13,88,70,315
Auburn3,3,TJ Lang,SO,G,Auburn,SEC,31,772,64,151,16,32,48,119,43,63,19,46,65,20,16,1,20,73,219
Auburn4,4,Bryce Brown,FR,G,Auburn,SEC,30,742,93,274,15,63,78,211,38,46,15,40,55,20,11,0,31,73,302
Auburn5,5,Kareem Canty,JR,G,Auburn,SEC,21,721,126,314,57,123,69,191,63,85,5,57,62,111,16,0,62,40,384
Auburn6,6,Jordon Granger,SR,F,Auburn,SEC,31,666,49,112,22,29,27,83,22,34,13,57,70,18,18,15,14,60,147
Auburn7,7,Horace Spencer,FR,F,Auburn,SEC,31,562,63,150,63,149,0,1,33,68,65,88,153,15,14,65,43,115,159
Auburn8,8,T.J. Dunans,JR,G,Auburn,SEC,16,470,65,141,51,99,14,42,41,59,10,30,40,54,25,17,49,53,185
Auburn9,9,Devin Waddell,JR,F,Auburn,SEC,26,170,2,14,1,4,1,10,1,2,3,7,10,3,6,0,10,30,6
Auburn10,10,Patrick Keim,SO,G,Auburn,SEC,23,150,2,14,0,3,2,11,4,9,2,10,12,5,4,0,10,19,10
Auburn11,11,New Williams,FR,G,Auburn,SEC,21,134,6,26,2,8,4,18,2,8,4,13,17,5,3,1,6,17,18
Auburn12,12,Tahj Shamsid-Deen,JR,G,Auburn,SEC,5,58,5,17,3,9,2,8,1,3,0,6,6,8,3,0,2,2,13
Auburn13,13,Jonathan Walker,SR,G,Auburn,SEC,10,19,2,6,0,1,2,5,0,0,1,2,3,0,0,0,0,0,6
Auburn14,14,Cole Stockton,SR,G,Auburn,SEC,8,14,1,5,0,2,1,3,2,2,1,1,2,2,0,0,0,1,5
Auburn15,15,Cole Blackstock,FR,F,Auburn,SEC,5,9,1,1,1,1,0,0,3,3,0,0,0,0,0,0,0,2,5
Austin Peay1,1,Josh Robinson,SO,G,Austin Peay,OVC,35,1191,178,446,109,241,69,205,159,191,14,97,111,91,35,0,95,47,584
Austin Peay2,2,Chris Horton,SR,C,Austin Peay,OVC,35,1177,243,402,243,402,0,0,176,281,173,248,421,54,47,63,97,72,662
Austin Peay3,3,Khalil Davis,SR,G,Austin Peay,OVC,35,1096,130,304,96,187,34,117,97,145,47,92,139,97,40,12,91,96,391
Austin Peay4,4,Kenny Jones,JR,F,Austin Peay,OVC,35,840,118,223,114,212,4,11,38,91,51,136,187,45,28,17,55,85,278
Austin Peay5,5,Jared Savage,FR,G,Austin Peay,OVC,35,681,74,172,22,44,52,128,27,33,19,85,104,29,24,1,18,54,227
Austin Peay6,6,Terrell Thompson,JR,G,Austin Peay,OVC,24,557,29,90,23,69,6,21,22,34,9,32,41,55,18,2,39,58,86
Austin Peay7,7,Zach Glotta,FR,G,Austin Peay,OVC,32,485,34,85,7,13,27,72,7,9,4,30,34,39,16,0,23,51,102
Austin Peay8,8,Chris Porter-Bunton,FR,G,Austin Peay,OVC,35,436,53,103,40,77,13,26,28,40,23,44,67,20,14,3,18,76,147
Austin Peay9,9,John Murry,JR,G,Austin Peay,OVC,26,275,40,89,28,52,12,37,37,50,8,35,43,9,8,0,23,22,129
Austin Peay10,10,Tre' Ivory,SO,G,Austin Peay,OVC,29,202,6,18,6,14,0,4,9,18,1,13,14,22,8,0,14,25,21
Austin Peay11,11,Assane Diop,JR,F,Austin Peay,OVC,20,96,8,26,7,25,1,1,0,0,6,15,21,11,1,2,9,20,17
Austin Peay12,12,Steve Harris,FR,G,Austin Peay,OVC,11,34,7,15,6,13,1,2,1,5,6,4,10,0,2,1,1,3,16
Ball State1,1,Francis Kiapway,SO,G,Ball State,MAC,32,871,90,205,21,43,69,162,36,51,2,40,42,49,19,3,36,49,285
Ball State2,2,Bo Calhoun,SR,F,Ball State,MAC,32,862,133,288,100,195,33,93,48,62,77,200,277,38,28,19,61,78,347
Ball State3,3,Ryan Weber,SR,G,Ball State,MAC,30,855,95,224,34,68,61,156,62,77,24,107,131,49,11,6,46,52,313
Ball State4,4,Franko House,JR,F,Ball State,MAC,32,853,142,253,139,239,3,14,113,160,74,103,177,66,21,19,58,101,400
Ball State5,5,Jeremie Tyler,SO,G,Ball State,MAC,32,702,98,260,47,116,51,144,27,37,2,44,46,31,22,11,23,55,274
Ball State6,6,Naiel Smith,JR,G,Ball State,MAC,32,586,34,98,23,61,11,37,11,24,5,75,80,86,35,4,53,73,90
Ball State7,7,Trey Moses,FR,F,Ball State,MAC,32,581,61,128,59,121,2,7,41,82,47,79,126,54,9,31,39,88,165
Ball State8,8,Sean Sellers,SO,F,Ball State,MAC,30,519,59,133,25,51,34,82,28,39,20,62,82,32,12,7,22,35,180
Ball State9,9,Jeremiah Davis,SR,G,Ball State,MAC,22,388,44,105,35,69,9,36,41,53,1,60,61,55,11,10,47,35,138
Ball State10,10,Nate Wells,SR,C,Ball State,MAC,28,216,17,38,17,38,0,0,11,21,6,32,38,8,5,9,13,36,45
Ball State11,11,Bik Gill,SR,F,Ball State,MAC,5,26,3,3,1,1,2,2,3,4,1,6,7,1,2,1,2,3,11
Ball State12,12,Kaleb Mallory,JR,G,Ball State,MAC,4,10,1,2,1,1,0,1,1,2,0,1,1,2,1,0,2,0,3
Baylor1,1,Lester Medford,SR,G,Baylor,Big 12,33,1070,96,241,54,128,42,113,67,89,11,66,77,216,54,3,77,84,301
Baylor2,2,Taurean Prince,SR,F,Baylor,Big 12,33,1006,175,409,126,269,49,140,113,146,79,123,202,74,42,25,90,84,512
Baylor3,3,Allerik Freeman,SO,G,Baylor,Big 12,33,993,122,289,73,163,49,126,86,100,23,88,111,57,26,0,43,46,379
Baylor4,4,Ishmail Wainright,JR,G,Baylor,Big 12,33,815,70,165,43,97,27,68,27,37,55,83,138,86,31,19,44,96,194
Baylor5,5,Rico Gathers,SR,F,Baylor,Big 12,31,801,130,252,129,251,1,1,92,145,124,159,283,16,29,25,38,77,353
Baylor6,6,Johnathan Motley,SO,F,Baylor,Big 12,33,684,148,239,148,237,0,2,66,111,74,93,167,30,16,39,49,97,362
Baylor7,7,King McClure,FR,G,Baylor,Big 12,33,435,52,115,23,39,29,76,17,25,8,29,37,21,29,4,14,45,150
Baylor8,8,Jake Lindsey,FR,G,Baylor,Big 12,33,414,30,75,26,58,4,17,14,20,9,40,49,66,15,5,24,53,78
Baylor9,9,T.J. Maston,SO,F,Baylor,Big 12,33,402,75,132,75,132,0,0,51,61,29,54,83,14,16,12,32,53,201
Baylor10,10,Austin Mills,SR,G,Baylor,Big 12,10,34,3,9,1,2,2,7,2,2,0,2,2,7,1,1,3,0,10
Baylor11,11,John Heard,SR,F,Baylor,Big 12,9,22,2,9,1,3,1,6,1,1,1,3,4,0,1,0,0,1,6
Belmont1,1,Craig Bradshaw,SR,G,Belmont,OVC,31,999,170,386,85,159,85,227,82,113,25,101,126,102,40,10,75,80,507
Belmont2,2,Evan Bradds,JR,F,Belmont,OVC,31,952,208,290,205,282,3,8,132,190,67,225,292,66,10,8,76,87,551
Belmont3,3,Taylor Barnette,JR,G,Belmont,OVC,31,906,109,265,37,68,72,197,38,47,5,59,64,65,14,5,17,46,328
Belmont4,4,Austin Luke,SO,G,Belmont,OVC,31,862,58,132,22,39,36,93,31,42,11,73,84,195,17,2,116,56,183
Belmont5,5,Amanze Egekeze,SO,F,Belmont,OVC,30,682,96,174,53,76,43,98,42,54,29,72,101,22,12,12,27,92,277
Belmont6,6,Dylan Windler,FR,G,Belmont,OVC,31,577,48,99,37,53,11,46,30,44,39,104,143,29,20,18,33,66,137
Belmont7,7,Kevin McClain,FR,G,Belmont,OVC,31,331,60,141,42,78,18,63,28,42,9,30,39,24,8,4,40,44,166
Belmont8,8,Nick Smith,JR,F,Belmont,OVC,27,329,54,136,12,15,42,121,18,27,14,33,47,8,5,1,13,43,168
Belmont9,9,Mack Mercer,SO,F,Belmont,OVC,22,253,63,122,54,99,9,23,38,46,26,44,70,9,6,15,14,46,173
Belmont10,10,Burton Sampson,SO,G,Belmont,OVC,14,102,4,6,2,3,2,3,2,4,1,2,3,6,7,0,7,11,12
Belmont11,11,Tyler Hadden,SO,C,Belmont,OVC,23,92,15,31,13,23,2,8,8,14,4,16,20,0,1,2,7,24,40
Belmont12,12,Josh Lester,SO,F,Belmont,OVC,13,33,3,6,2,3,1,3,3,4,1,5,6,0,0,0,2,5,10
Bethune-Cookman1,1,Jordan Potts,JR,G,Bethune-Cookman,MEAC,32,1207,156,448,71,183,85,265,116,149,19,82,101,138,50,3,90,76,513
Bethune-Cookman2,2,Ricky Johnson,SR,G,Bethune-Cookman,MEAC,32,1030,102,295,53,126,49,169,86,110,19,69,88,57,26,0,53,66,339
Bethune-Cookman3,3,Mario Moody,SR,F,Bethune-Cookman,MEAC,32,889,153,313,125,228,28,85,81,116,79,158,237,33,29,76,80,101,415
Bethune-Cookman4,4,LaRon Smith,JR,F,Bethune-Cookman,MEAC,32,814,108,184,108,184,0,0,13,49,91,131,222,19,11,96,37,95,229
Bethune-Cookman5,5,Randy Holmes,JR,F,Bethune-Cookman,MEAC,32,714,70,184,54,125,16,59,42,53,44,82,126,29,23,7,43,89,198
Bethune-Cookman6,6,Diamante Lewis,JR,G,Bethune-Cookman,MEAC,30,628,86,216,59,147,27,69,30,49,42,75,117,44,22,3,37,74,229
Bethune-Cookman7,7,Quinton Forrest,FR,G,Bethune-Cookman,MEAC,30,495,61,116,57,95,4,21,22,44,39,41,80,18,22,5,27,29,148
Bethune-Cookman8,8,Marquel Ingram,FR,G,Bethune-Cookman,MEAC,27,347,25,77,11,30,14,47,16,18,11,34,45,21,8,0,25,35,80
Bethune-Cookman9,9,Josue Salaam,JR,G,Bethune-Cookman,MEAC,27,326,36,95,10,25,26,70,5,9,8,36,44,11,5,0,8,33,103
Bethune-Cookman10,10,Gus Navickas,FR,F,Bethune-Cookman,MEAC,1,13,2,2,2,2,0,0,0,0,0,4,4,1,0,1,2,1,4
Binghamton1,1,Marlon Beck,JR,G,Binghamton,AEC,30,984,92,263,19,59,73,204,38,56,9,72,81,62,34,1,44,66,295
Binghamton2,2,Willie Rodriguez,SO,F,Binghamton,AEC,30,945,156,346,134,262,22,84,118,154,66,134,200,39,32,9,78,84,452
Binghamton3,3,Everson Davis,FR,G,Binghamton,AEC,30,862,95,271,85,212,10,59,81,112,21,104,125,75,25,8,92,85,281
Binghamton4,4,Thomas Bruce,FR,F,Binghamton,AEC,26,715,68,126,68,126,0,0,40,84,46,83,129,22,12,26,38,54,176
Binghamton5,5,Justin McFadden,SO,G,Binghamton,AEC,29,662,34,98,23,55,11,43,43,61,31,78,109,28,22,11,45,70,122
Binghamton6,6,Dusan Perovic,SO,C,Binghamton,AEC,30,482,57,190,29,97,28,93,20,27,10,60,70,23,4,4,26,51,162
Binghamton7,7,Bobby Ahearn,SO,F,Binghamton,AEC,29,472,55,112,55,112,0,0,30,40,31,71,102,17,6,5,30,72,140
Binghamton8,8,Timmy Rose,FR,G,Binghamton,AEC,30,414,36,90,25,49,11,41,14,29,6,36,42,46,13,0,29,34,97
Binghamton9,9,John Rinaldi,JR,G,Binghamton,AEC,26,177,8,12,8,11,0,1,6,9,9,33,42,12,9,0,12,19,22
Binghamton10,10,John Schurman,FR,G,Binghamton,AEC,24,175,16,62,4,9,12,53,0,1,7,15,22,2,3,1,3,11,44
Binghamton11,11,Romello Walker,SO,G,Binghamton,AEC,7,127,11,42,7,21,4,21,8,11,3,19,22,7,1,3,12,11,34
Binghamton12,12,Jordan McRae,SO,F,Binghamton,AEC,6,10,1,2,1,2,0,0,0,0,0,0,0,0,0,0,0,1,2
Boise State1,1,Nick Duncan,JR,F,Boise State,MWC,32,1013,118,269,56,92,62,177,72,95,36,99,135,58,30,17,57,103,370
Boise State2,2,Mikey Thompson,SR,G,Boise State,MWC,32,1008,122,263,97,194,25,69,111,135,19,70,89,121,35,0,65,49,380
Boise State3,3,James Webb,JR,F,Boise State,MWC,31,944,177,358,150,249,27,109,108,158,74,209,283,34,44,20,49,94,489
Boise State4,4,Anthony Drmic,SR,G,Boise State,MWC,31,906,134,308,73,128,61,180,85,120,30,106,136,44,28,0,49,93,414
Boise State5,5,Lonnie Jackson,SR,G,Boise State,MWC,32,678,70,171,16,31,54,140,20,27,7,52,59,49,15,1,31,51,214
Boise State6,6,Chandler Hutchison,SO,G,Boise State,MWC,31,615,80,161,77,148,3,13,49,77,51,76,127,41,21,11,31,65,212
Boise State7,7,Montigo Alford,SR,G,Boise State,MWC,29,417,37,102,19,41,18,61,26,36,1,36,37,44,15,4,35,51,118
Boise State8,8,Paris Austin,FR,G,Boise State,MWC,30,368,41,103,35,80,6,23,35,57,4,42,46,35,9,0,22,25,123
Boise State9,9,Zach Haney,FR,F,Boise State,MWC,30,268,39,81,34,67,5,14,9,18,26,35,61,2,8,7,14,39,92
Boise State10,10,Robin Jorch,FR,C,Boise State,MWC,22,154,15,30,15,28,0,2,12,21,13,5,18,0,2,2,9,39,42
Boise State11,11,David Wacker,SO,F,Boise State,MWC,7,80,9,13,9,13,0,0,8,11,8,12,20,2,2,2,5,13,26
Boston College1,1,Eli Carter,SR,G,Boston College,ACC,31,1034,174,469,110,240,64,229,83,106,11,110,121,125,37,7,107,59,495
Boston College2,2,Dennis Clifford,SR,C,Boston College,ACC,31,853,119,241,118,230,1,11,69,112,61,166,227,39,16,34,66,89,308
Boston College3,3,Jerome Robinson,FR,G,Boston College,ACC,23,769,100,233,77,171,23,62,46,71,9,84,93,70,32,7,61,49,269
Boston College4,4,A.J. Turner,FR,F,Boston College,ACC,27,744,54,161,29,65,25,96,24,35,10,88,98,42,25,10,20,39,157
Boston College5,5,Garland Owens,JR,F,Boston College,ACC,32,700,58,131,51,105,7,26,30,46,41,66,107,41,15,9,40,91,153
Boston College6,6,Ervins Meznieks,FR,F,Boston College,ACC,32,608,38,114,13,32,25,82,12,22,17,47,64,31,16,3,23,61,113
Boston College7,7,Matt Milon,FR,G,Boston College,ACC,30,499,55,119,16,40,39,79,14,14,10,31,41,16,8,2,26,32,163
Boston College8,8,Sammy Barnes-Thompkins,FR,G,Boston College,ACC,27,457,53,137,22,58,31,79,12,21,6,37,43,18,16,5,25,58,149
Boston College9,9,Darryl Hicks,SO,G,Boston College,ACC,24,349,27,78,15,37,12,41,3,7,10,16,26,19,11,2,23,27,69
Boston College10,10,Idy Diallo,FR,F,Boston College,ACC,31,302,26,44,26,44,0,0,1,14,14,46,60,5,2,11,22,65,53
Boston College11,11,Johncarlos Reyes,FR,F,Boston College,ACC,7,59,7,12,7,12,0,0,1,4,9,15,24,2,3,3,4,6,15
Boston College12,12,Steve Perpiglia,SR,G,Boston College,ACC,9,25,2,7,1,3,1,4,0,1,1,3,4,2,0,0,3,1,5
Boston College13,13,Gordon Gehan,FR,G,Boston College,ACC,7,14,2,3,2,3,0,0,0,0,2,0,2,0,0,0,0,0,4
Boston College14,14,Aser Ghebremichael,FR,F,Boston College,ACC,2,7,1,1,0,0,1,1,0,0,0,1,1,0,0,0,0,2,3
Boston College15,15,Jordan Barros,FR,G,Boston College,ACC,2,7,1,2,0,0,1,2,0,0,0,1,1,0,0,0,0,0,3
Boston University1,1,John Papale,SR,G,Boston University,Patriot,32,1156,125,309,40,94,85,215,30,36,8,79,87,70,21,6,25,44,365
Boston University2,2,Kyle Foreman,FR,G,Boston University,Patriot,29,848,89,208,61,122,28,86,60,80,6,72,78,112,33,3,76,63,266
Boston University3,3,Cheddi Mosely,SO,G,Boston University,Patriot,28,838,117,291,51,93,66,198,76,96,11,76,87,28,26,3,54,55,376
Boston University4,4,Nathan Dieudonne,SR,F,Boston University,Patriot,26,749,99,194,94,176,5,18,64,112,70,135,205,55,24,7,63,89,267
Boston University5,5,Eric Fanning,JR,G,Boston University,Patriot,26,684,122,247,98,178,24,69,129,166,33,105,138,39,13,10,72,68,397
Boston University6,6,Nick Havener,SO,F,Boston University,Patriot,32,672,90,184,88,178,2,6,33,53,53,143,196,42,36,39,48,108,215
Boston University7,7,Blaise Mbargorba,JR,C,Boston University,Patriot,32,443,60,102,60,102,0,0,23,33,29,53,82,6,3,29,26,57,143
Boston University8,8,Eric Johnson,SO,G,Boston University,Patriot,21,343,25,66,10,31,15,35,14,19,3,20,23,41,17,2,18,34,79
Boston University9,9,Dylan Haines,JR,F,Boston University,Patriot,26,297,35,74,24,47,11,27,7,11,16,56,72,13,5,20,26,41,88
Boston University10,10,Justin Alston,SR,F,Boston University,Patriot,8,177,26,56,26,56,0,0,18,28,12,27,39,12,3,3,10,24,70
Boston University11,11,Kamali Chambers,FR,G,Boston University,Patriot,23,128,7,19,3,6,4,13,4,7,1,6,7,8,1,0,4,15,22
Boston University12,12,Will Goff,SO,G,Boston University,Patriot,7,98,9,16,3,4,6,12,1,3,2,9,11,4,0,0,4,4,25
Boston University13,13,Brandon Johnson,FR,G,Boston University,Patriot,12,31,7,14,3,4,4,10,1,1,2,3,5,2,0,0,3,4,19
Boston University14,14,Cedric Hankerson,JR,G,Boston University,Patriot,1,12,2,7,0,2,2,5,4,4,0,3,3,0,1,0,0,3,10
Bowling Green State1,1,Spencer Parker,SR,F,Bowling Green State,MAC,34,986,164,355,131,277,33,78,116,162,51,124,175,58,16,14,80,73,477
Bowling Green State2,2,Zack Denny,JR,G,Bowling Green State,MAC,34,919,131,321,79,179,52,142,47,70,42,163,205,29,41,5,44,59,361
Bowling Green State3,3,Wesley Alcegaire,JR,G,Bowling Green State,MAC,34,906,120,293,68,146,52,147,56,75,31,81,112,21,18,13,40,76,348
Bowling Green State4,4,Ismail Ali,JR,G,Bowling Green State,MAC,34,718,48,124,41,99,7,25,82,117,10,61,71,130,28,9,73,81,185
Bowling Green State5,5,Antwon Lillard,FR,G,Bowling Green State,MAC,34,717,107,209,91,150,16,59,61,97,38,76,114,21,25,9,44,73,291
Bowling Green State6,6,David Joseph,SR,G,Bowling Green State,MAC,34,699,61,158,41,113,20,45,28,43,7,75,82,100,38,6,49,54,170
Bowling Green State7,7,Rasheed Worrell,FR,F,Bowling Green State,MAC,34,681,96,193,92,184,4,9,47,80,54,102,156,16,8,29,27,92,243
Bowling Green State8,8,Demajeo Wiggins,FR,F,Bowling Green State,MAC,32,499,62,110,62,110,0,0,22,58,42,98,140,3,6,17,27,56,146
Bowling Green State9,9,J.D. Tisdale,JR,G,Bowling Green State,MAC,33,340,28,67,27,61,1,6,29,42,20,31,51,14,19,8,28,47,86
Bowling Green State10,10,Matt Fox,SO,G,Bowling Green State,MAC,18,134,14,35,0,1,14,34,2,2,3,6,9,0,3,1,2,9,44
Bowling Green State11,11,Garrett Mayleben,SO,F,Bowling Green State,MAC,16,96,5,16,4,13,1,3,4,7,2,11,13,2,0,1,5,19,15
Bowling Green State12,12,Malik Hluchoweckyj,FR,G,Bowling Green State,MAC,9,45,6,12,5,6,1,6,2,2,3,2,5,3,4,0,2,4,15
Bowling Green State13,13,Josh Gomez,SR,C,Bowling Green State,MAC,8,41,5,10,4,8,1,2,3,5,1,6,7,1,3,1,4,10,14
Bowling Green State14,14,Brandon Busuttil,SR,G,Bowling Green State,MAC,7,19,2,10,1,3,1,7,0,1,1,2,3,0,0,0,0,2,5
Bradley1,1,Dwayne Lautier-Ogunleye,FR,G,Bradley,MVC,32,1035,93,247,65,161,28,86,101,169,7,121,128,94,22,9,108,87,315
Bradley2,2,Ronnie Suggs,FR,G,Bradley,MVC,32,965,91,271,61,156,30,115,61,87,20,109,129,42,20,6,57,82,273
Bradley3,3,Luuk van Bree,FR,F,Bradley,MVC,30,810,90,235,46,110,44,125,29,44,39,100,139,26,17,13,52,113,253
Bradley4,4,Antoine Pittman,FR,G,Bradley,MVC,29,795,81,223,56,135,25,88,50,66,24,42,66,36,22,5,62,80,237
Bradley5,5,Donte Thomas,SO,F,Bradley,MVC,31,771,97,223,79,157,18,66,69,93,49,143,192,24,17,15,68,109,281
Bradley6,6,Callum Barker,FR,F,Bradley,MVC,32,730,59,128,56,104,3,24,42,69,44,99,143,10,12,14,59,104,163
Bradley7,7,Ka'Darryl Bell,SR,G,Bradley,MVC,22,338,27,80,21,50,6,30,16,22,4,17,21,13,15,2,36,49,76
Bradley8,8,Scottie James,FR,F,Bradley,MVC,30,298,31,79,22,44,9,35,25,36,31,48,79,7,3,11,17,41,96
Bradley9,9,Joel Okafor,FR,G,Bradley,MVC,26,280,10,40,10,28,0,12,8,19,5,25,30,29,9,1,32,41,28
Bradley10,10,Davante Cooper,FR,C,Bradley,MVC,26,208,18,42,18,42,0,0,7,11,5,29,34,3,0,7,14,24,43
Bradley11,11,Peter Hanley,FR,F,Bradley,MVC,27,187,9,23,7,16,2,7,2,3,8,24,32,8,4,3,10,12,22
Brigham Young1,1,Kyle Collinsworth,SR,G,Brigham Young,WCC,33,1124,182,398,173,363,9,35,127,194,83,194,277,244,65,20,112,67,500
Brigham Young2,2,Chase Fischer,SR,G,Brigham Young,WCC,33,1113,179,437,81,168,98,269,135,161,12,70,82,66,34,2,47,55,591
Brigham Young3,3,Nick Emery,FR,G,Brigham Young,WCC,32,986,183,424,96,196,87,228,65,78,15,90,105,78,45,2,45,88,518
Brigham Young4,4,Kyle Davis,JR,F,Brigham Young,WCC,33,892,159,294,153,281,6,13,74,122,77,175,252,44,24,46,59,84,398
Brigham Young5,5,Zac Seljaas,FR,G,Brigham Young,WCC,31,583,76,157,18,39,58,118,16,24,17,70,87,37,14,10,17,54,226
Brigham Young6,6,Nate Austin,SR,F,Brigham Young,WCC,33,520,34,58,34,57,0,1,15,28,52,100,152,19,13,15,18,90,83
Brigham Young7,7,Corbin Kaufusi,SO,C,Brigham Young,WCC,32,508,70,113,70,113,0,0,43,74,55,86,141,9,10,36,34,86,183
Brigham Young8,8,Jordan Chatman,FR,G,Brigham Young,WCC,32,334,33,88,16,38,17,50,7,10,3,29,32,24,3,5,17,34,90
Brigham Young9,9,Jamal Aytes,SO,F,Brigham Young,WCC,21,185,28,52,28,52,0,0,11,22,11,24,35,3,1,1,16,29,67
Brigham Young10,10,Jake Toolson,SO,G,Brigham Young,WCC,10,138,15,33,8,14,7,19,2,2,3,13,16,12,3,0,7,7,39
Brigham Young11,11,Jakob Hartsock,FR,F,Brigham Young,WCC,20,132,11,39,1,6,10,33,0,0,3,24,27,4,2,2,4,17,32
Brigham Young12,12,Braiden Shaw,FR,F,Brigham Young,WCC,18,55,3,6,3,6,0,0,6,12,5,10,15,3,4,1,3,9,12
Brigham Young13,13,Cory Calvert,SO,G,Brigham Young,WCC,5,26,2,8,1,4,1,4,0,0,0,5,5,1,0,0,0,2,5
Brigham Young14,14,Davin Guinn,SO,F,Brigham Young,WCC,7,25,4,10,3,7,1,3,5,8,5,5,10,1,1,0,1,1,14
Brown1,1,Tavon Blackmon,JR,G,Brown,Ivy,26,894,114,250,86,187,28,63,90,120,10,50,60,144,30,0,83,62,346
Brown2,2,Steven Spieth,JR,G,Brown,Ivy,28,866,93,215,67,135,26,80,93,112,44,157,201,104,26,10,58,90,305
Brown3,3,Cedric Kuakumensah,SR,F,Brown,Ivy,28,832,147,314,115,240,32,74,65,92,72,196,268,33,7,76,65,73,391
Brown4,4,JR Hobbie,JR,G,Brown,Ivy,28,704,78,189,6,17,72,172,23,27,3,29,32,16,8,0,16,46,251
Brown5,5,Jason Massey,SO,G,Brown,Ivy,27,535,59,133,52,106,7,27,41,70,26,70,96,29,13,3,27,55,166
Brown6,6,Obi Okolie,FR,G,Brown,Ivy,19,471,67,143,58,117,9,26,47,72,26,56,82,19,18,3,23,34,190
Brown7,7,Travis Fuller,FR,F,Brown,Ivy,28,301,30,68,25,52,5,16,13,39,27,41,68,18,8,6,24,45,78
Brown8,8,Kyle Haber,SO,F,Brown,Ivy,23,286,18,52,9,20,9,32,8,11,12,22,34,10,9,1,17,17,53
Brown9,9,Corey Daugherty,FR,G,Brown,Ivy,16,279,32,97,18,34,14,63,9,14,7,18,25,23,13,0,16,38,87
Brown10,10,Justin Massey,SO,G,Brown,Ivy,9,197,28,67,13,21,15,46,12,16,2,25,27,3,6,0,10,21,83
Brown11,11,Patrick Triplett,SO,G,Brown,Ivy,15,138,13,33,10,22,3,11,10,15,2,13,15,1,5,2,12,30,39
Brown12,12,Aram Martin,JR,F,Brown,Ivy,16,86,8,31,8,20,0,11,4,4,3,18,21,6,1,13,8,15,20
Brown13,13,Chris Sullivan,FR,G,Brown,Ivy,22,72,7,19,3,6,4,13,0,0,3,4,7,3,3,0,3,13,18
Brown14,14,Tyler Williams,SO,G,Brown,Ivy,7,25,1,9,0,6,1,3,4,6,0,2,2,4,2,0,2,4,7
Brown15,15,Miki Ljuboja,SO,F,Brown,Ivy,7,14,2,5,2,3,0,2,2,2,1,3,4,1,1,0,2,0,6
Bryant1,1,Shane McLaughlin,SR,G,Bryant,NEC,31,1134,86,215,61,143,25,72,43,73,9,97,106,165,29,1,95,65,240
Bryant2,2,Hunter Ware,SO,G,Bryant,NEC,30,977,141,341,80,175,61,166,39,59,19,78,97,44,38,5,63,77,382
Bryant3,3,Marcel Pettway,FR,F,Bryant,NEC,30,965,151,253,151,253,0,0,41,83,72,139,211,55,32,19,49,71,343
Bryant4,4,Nisre Zouzoua,FR,G,Bryant,NEC,31,939,131,321,71,159,60,162,75,89,20,78,98,44,25,8,45,86,397
Bryant5,5,Dan Garvin,JR,F,Bryant,NEC,26,689,111,245,110,237,1,8,42,80,84,123,207,31,18,35,56,89,265
Bryant6,6,Curtis Oakley,SR,G,Bryant,NEC,28,466,48,146,29,69,19,77,19,32,11,60,71,23,6,1,29,49,134
Bryant7,7,Angus Riley,SO,F,Bryant,NEC,27,299,33,91,17,38,16,53,14,17,14,30,44,10,5,4,14,45,96
Bryant8,8,Bosko Kostur,SO,G,Bryant,NEC,20,299,32,95,24,51,8,44,14,19,12,32,44,7,9,3,24,45,86
Bryant9,9,Justin Brickman,JR,G,Bryant,NEC,19,176,9,31,6,22,3,9,8,9,5,16,21,21,11,0,19,20,29
Bryant10,10,Andrew Scocca,JR,F,Bryant,NEC,23,133,3,15,3,15,0,0,11,14,9,19,28,8,1,6,3,21,17
Bryant11,11,Dennis Levene,SR,F,Bryant,NEC,18,50,4,8,3,5,1,3,0,3,2,10,12,3,1,1,3,6,9
Bryant12,12,Zach Chionuma,SR,G,Bryant,NEC,8,49,5,21,2,8,3,13,0,0,0,7,7,1,0,0,2,9,13
Bryant13,13,Terrill Toe,JR,G,Bryant,NEC,14,25,1,5,0,1,1,4,0,0,1,0,1,0,1,0,1,0,3
Bucknell1,1,Chris Hass,SR,G,Bucknell,Patriot,29,910,157,372,101,201,56,171,129,155,22,92,114,48,33,14,61,63,499
Bucknell2,2,Stephen Brown,SO,G,Bucknell,Patriot,30,856,89,178,75,139,14,39,84,101,22,74,96,160,37,2,61,64,276
Bucknell3,3,Ryan Frazier,SR,G,Bucknell,Patriot,30,810,70,180,41,101,29,79,76,95,10,40,50,52,19,0,31,66,245
Bucknell4,4,Nana Foulland,SO,C,Bucknell,Patriot,30,797,138,259,138,259,0,0,79,159,69,137,206,24,15,42,65,77,355
Bucknell5,5,Zach Thomas,SO,F,Bucknell,Patriot,28,572,97,207,66,125,31,82,60,87,31,127,158,38,20,11,44,65,285
Bucknell6,6,Dom Hoffman,SR,F,Bucknell,Patriot,30,562,70,141,48,83,22,58,23,27,38,100,138,49,21,10,29,72,185
Bucknell7,7,Kimbal MacKenzie,FR,G,Bucknell,Patriot,30,465,39,103,19,48,20,55,31,38,3,31,34,49,14,3,39,59,129
Bucknell8,8,D.J. MacLeay,JR,F,Bucknell,Patriot,30,364,61,96,55,82,6,14,27,39,47,61,108,18,15,14,34,71,155
Bucknell9,9,Nate Jones,FR,G,Bucknell,Patriot,27,318,25,58,10,18,15,40,12,20,4,33,37,20,6,1,13,33,77
Bucknell10,10,John Azzinaro,JR,G,Bucknell,Patriot,28,307,30,77,12,31,18,46,9,17,2,31,33,12,13,1,16,31,87
Bucknell11,11,Matt O'Reilly,FR,G,Bucknell,Patriot,12,46,10,20,0,0,10,20,1,2,0,2,2,1,0,0,0,8,31
Bucknell12,12,Ben Oberfeld,JR,C,Bucknell,Patriot,11,44,7,12,7,12,0,0,5,10,7,7,14,0,0,0,5,17,19
Bucknell13,13,Matt Banas,SR,F,Bucknell,Patriot,9,41,4,11,4,10,0,1,2,3,5,2,7,1,2,0,2,8,10
Bucknell14,14,Nate Sestina,FR,C,Bucknell,Patriot,4,32,6,11,4,8,2,3,1,1,1,4,5,3,2,0,4,7,15
Buffalo1,1,Willie Conner,JR,F,Buffalo,MAC,34,982,132,286,85,150,47,136,99,135,24,55,79,40,30,11,48,74,410
Buffalo2,2,Jarryn Skeete,SR,G,Buffalo,MAC,34,953,86,270,26,87,60,183,40,57,21,90,111,76,31,2,44,72,272
Buffalo3,3,Blake Hamilton,JR,F,Buffalo,MAC,33,870,148,323,98,190,50,133,87,116,45,186,231,84,46,12,95,94,433
Buffalo4,4,Lamonte Bearden,SO,G,Buffalo,MAC,29,861,125,296,110,236,15,60,128,166,22,63,85,122,46,8,64,73,393
Buffalo5,5,C.J. Massinburg,FR,G,Buffalo,MAC,34,856,120,268,76,158,44,110,101,136,42,98,140,58,39,15,49,63,385
Buffalo6,6,Nick Perkins,FR,F,Buffalo,MAC,34,647,90,207,62,116,28,91,37,65,37,107,144,11,8,14,48,82,245
Buffalo7,7,Rodell Wigginton,SR,G,Buffalo,MAC,32,577,85,186,80,165,5,21,55,83,61,112,173,24,18,17,57,73,230
Buffalo8,8,Ikenna Smart,FR,F,Buffalo,MAC,34,540,46,85,46,85,0,0,21,36,63,88,151,5,9,20,30,110,113
Buffalo9,9,David Kadiri,JR,F,Buffalo,MAC,29,344,42,70,42,70,0,0,26,40,33,31,64,2,2,20,13,64,110
Buffalo10,10,Nikola Rakicevic,FR,F,Buffalo,MAC,19,166,15,30,11,20,4,10,6,11,12,18,30,9,6,1,10,9,40
Buffalo11,11,Raheem Johnson,SR,F,Buffalo,MAC,2,16,2,4,2,4,0,0,0,0,2,5,7,0,0,2,0,3,4
Buffalo12,12,Zac DiSalvo,FR,G,Buffalo,MAC,4,6,1,3,1,1,0,2,0,0,3,0,3,1,0,0,0,2,2
Butler1,1,Roosevelt Jones,SR,F,Butler,Big East,31,1038,159,331,158,330,1,1,115,169,63,142,205,146,46,13,73,77,434
Butler2,2,Kellen Dunham,SR,G,Butler,Big East,31,1000,155,356,75,169,80,187,114,136,15,65,80,46,19,3,48,55,504
Butler3,3,Andrew Chrabascz,JR,F,Butler,Big East,31,926,115,238,96,178,19,60,65,82,48,83,131,61,31,14,30,79,314
Butler4,4,Kelan Martin,SO,F,Butler,Big East,31,872,177,392,133,276,44,116,102,135,51,161,212,34,22,17,53,84,500
Butler5,5,Tyler Wideman,SO,F,Butler,Big East,31,761,90,152,90,151,0,1,58,97,68,109,177,25,33,48,31,108,238
Butler6,6,Tyler Lewis,JR,G,Butler,Big East,27,540,51,134,32,69,19,65,46,54,7,33,40,82,21,0,22,44,167
Butler7,7,Jordan Gathers,SR,G,Butler,Big East,31,408,47,116,18,43,29,73,10,18,8,32,40,23,14,1,20,52,133
Butler8,8,Austin Etherington,SR,F,Butler,Big East,28,322,34,64,13,16,21,48,17,26,11,39,50,13,14,3,16,52,106
Butler9,9,Jackson Davis,SO,F,Butler,Big East,25,142,25,45,25,44,0,1,12,17,9,32,41,2,7,4,10,30,62
Butler10,10,Nate Fowler,FR,C,Butler,Big East,20,125,10,18,8,15,2,3,1,3,11,15,26,4,2,1,7,29,23
Butler11,11,Steven Bennett,JR,G,Butler,Big East,13,50,3,10,0,0,3,10,0,0,1,6,7,3,0,0,3,3,9
Butler12,12,Trey Pettus,JR,G,Butler,Big East,10,41,2,8,0,4,2,4,2,4,1,5,6,6,1,0,0,2,8
Cal Poly1,1,David Nwaba,SR,G,Cal Poly,Big West,30,840,132,286,130,272,2,14,109,175,65,125,190,105,37,14,62,61,375
Cal Poly2,2,Reese Morgan,SR,G,Cal Poly,Big West,30,755,85,223,11,47,74,176,86,102,17,74,91,52,29,4,21,75,330
Cal Poly3,3,Ridge Shipley,JR,G,Cal Poly,Big West,29,671,51,150,16,42,35,108,23,36,8,41,49,62,20,2,35,45,160
Cal Poly4,4,Taylor Sutlive,SO,G,Cal Poly,Big West,29,624,63,148,17,33,46,115,6,9,14,38,52,43,23,6,16,48,178
Cal Poly5,5,Joel Awich,SR,F,Cal Poly,Big West,28,611,81,205,60,130,21,75,42,56,30,89,119,21,9,29,36,60,225
Cal Poly6,6,Luke Meikle,SO,F,Cal Poly,Big West,30,586,80,207,49,121,31,86,51,66,18,74,92,17,8,10,18,66,242
Cal Poly7,7,Jaylen Shead,FR,G,Cal Poly,Big West,30,585,45,128,28,71,17,57,24,32,27,57,84,84,17,0,38,49,131
Cal Poly8,8,Brian Bennett,SR,F,Cal Poly,Big West,30,577,123,240,123,240,0,0,23,47,43,78,121,22,6,6,24,55,269
Cal Poly9,9,Zach Gordon,JR,F,Cal Poly,Big West,30,399,42,75,42,75,0,0,25,45,40,57,97,5,7,11,19,86,109
Cal Poly10,10,Josh Martin,FR,F,Cal Poly,Big West,21,335,45,119,39,96,6,23,33,57,30,52,82,13,7,13,29,49,129
Cal Poly11,11,Trevor John,FR,G,Cal Poly,Big West,18,81,7,29,1,2,6,27,1,1,1,2,3,1,0,0,2,4,21
Cal Poly12,12,Mark Patterson,SO,G,Cal Poly,Big West,3,7,1,2,1,2,0,0,0,0,0,1,1,0,0,0,0,0,2
Cal State Bakersfield1,1,Dedrick Basile,JR,G,Cal State Bakersfield,WAC,32,937,147,313,100,182,47,131,42,58,21,88,109,116,59,7,58,77,383
Cal State Bakersfield2,2,Brent Wrapp,SO,G,Cal State Bakersfield,WAC,32,917,49,123,39,85,10,38,57,80,30,88,118,136,40,10,49,77,165
Cal State Bakersfield3,3,Aly Ahmed,SR,C,Cal State Bakersfield,WAC,32,895,162,347,161,345,1,2,89,132,56,142,198,33,21,34,77,90,414
Cal State Bakersfield4,4,Kevin Mays,SR,F,Cal State Bakersfield,WAC,32,800,156,302,150,284,6,18,83,125,112,143,255,32,32,10,40,90,401
Cal State Bakersfield5,5,Jaylin Airington,JR,F,Cal State Bakersfield,WAC,28,795,94,215,73,151,21,64,79,104,34,81,115,61,27,11,44,83,288
Cal State Bakersfield6,6,Damiyne Durham,FR,G,Cal State Bakersfield,WAC,31,691,128,339,39,93,89,246,21,34,16,87,103,22,30,4,30,32,366
Cal State Bakersfield7,7,Justin Pride,JR,G,Cal State Bakersfield,WAC,32,569,34,97,34,96,0,1,59,101,21,51,72,92,26,4,36,77,127
Cal State Bakersfield8,8,Justin Hollins,JR,F,Cal State Bakersfield,WAC,31,376,23,44,23,44,0,0,8,20,24,59,83,3,7,60,24,65,54
Cal State Bakersfield9,9,Matt Smith,JR,F,Cal State Bakersfield,WAC,25,359,48,82,48,82,0,0,18,43,37,34,71,6,14,19,14,66,114
Cal State Bakersfield10,10,Bray Barnes,FR,F,Cal State Bakersfield,WAC,19,77,4,11,4,7,0,4,8,10,5,3,8,0,1,2,3,21,16
Cal State Bakersfield11,11,PJ Posey,JR,F,Cal State Bakersfield,WAC,5,19,4,5,4,5,0,0,0,3,2,3,5,0,0,1,2,8,8
Cal State Fullerton1,1,Tre' Coggins,JR,G,Cal State Fullerton,Big West,29,865,145,368,70,158,75,210,87,102,14,98,112,52,20,4,71,61,452
Cal State Fullerton2,2,Khalil Ahmad,FR,G,Cal State Fullerton,Big West,30,818,139,324,103,214,36,110,114,148,23,109,132,48,24,6,55,67,428
Cal State Fullerton3,3,Jamar Akoh,SO,F,Cal State Fullerton,Big West,29,762,61,157,60,149,1,8,54,89,58,125,183,43,13,9,54,68,177
Cal State Fullerton4,4,Lionheart Leslie,JR,G,Cal State Fullerton,Big West,29,718,78,179,59,114,19,65,67,94,20,70,90,52,27,1,41,77,242
Cal State Fullerton5,5,Malcolm Brooks,SR,G,Cal State Fullerton,Big West,26,585,103,243,62,132,41,111,58,75,8,25,33,28,10,1,31,40,305
Cal State Fullerton6,6,Kyle Allman,FR,G,Cal State Fullerton,Big West,30,563,42,115,33,79,9,36,58,90,3,46,49,31,13,3,48,64,151
Cal State Fullerton7,7,Kennedy Esume,SR,C,Cal State Fullerton,Big West,30,529,31,91,31,91,0,0,23,43,62,98,160,9,14,9,23,68,85
Cal State Fullerton8,8,Malcolm Henderson,SR,F,Cal State Fullerton,Big West,30,453,33,63,33,63,0,0,21,40,40,52,92,4,6,4,17,63,87
Cal State Fullerton9,9,Tim Myles,JR,F,Cal State Fullerton,Big West,29,370,18,40,18,40,0,0,18,38,48,74,122,10,11,6,22,69,54
Cal State Fullerton10,10,Lanerryl Johnson,SR,G,Cal State Fullerton,Big West,10,202,37,94,28,62,9,32,12,16,3,15,18,13,2,0,17,11,95
Cal State Fullerton11,11,Sheldon Blackwell,JR,G,Cal State Fullerton,Big West,8,117,4,13,4,12,0,1,1,5,3,21,24,13,4,4,5,18,9
Cal State Fullerton12,12,Rashard Todd,JR,F,Cal State Fullerton,Big West,6,43,7,16,4,7,3,9,2,3,3,5,8,1,3,1,2,4,19
Cal State Northridge1,1,Tre Hale-Edmerson,SR,F,Cal State Northridge,Big West,30,952,97,196,76,137,21,59,37,51,21,169,190,94,26,52,60,98,252
Cal State Northridge2,2,Micheal Warren,FR,G,Cal State Northridge,Big West,30,887,120,268,93,189,27,79,115,145,34,88,122,65,40,8,55,91,382
Cal State Northridge3,3,Tavrion Dawson,FR,F,Cal State Northridge,Big West,30,773,109,235,103,202,6,33,73,101,52,102,154,33,12,10,33,64,297
Cal State Northridge4,4,Kendall Smith,JR,G,Cal State Northridge,Big West,21,721,103,267,81,186,22,81,93,137,12,50,62,64,24,1,49,43,321
Cal State Northridge5,5,Olalekan Ajayi,SR,F,Cal State Northridge,Big West,26,654,47,95,47,95,0,0,33,51,59,137,196,11,20,13,44,76,127
Cal State Northridge6,6,Jason Richardson,FR,G,Cal State Northridge,Big West,30,587,71,175,62,141,9,34,45,71,13,40,53,71,21,1,51,65,196
Cal State Northridge7,7,Aaron Parks,JR,G,Cal State Northridge,Big West,15,467,64,159,62,151,2,8,70,87,18,45,63,28,23,0,31,45,200
Cal State Northridge8,8,Zacarry Douglas,SO,F,Cal State Northridge,Big West,24,417,45,98,42,86,3,12,29,44,29,61,90,13,13,7,23,37,122
Cal State Northridge9,9,Jerron Wilbut,SO,G,Cal State Northridge,Big West,19,329,64,162,39,77,25,85,28,39,10,17,27,17,13,2,32,49,181
Cal State Northridge10,10,Landon Drew,SR,G,Cal State Northridge,Big West,15,309,22,54,11,26,11,28,0,1,5,14,19,26,8,2,25,27,55
Cal State Northridge11,11,Mehran Nazarian,FR,G,Cal State Northridge,Big West,6,17,3,10,3,5,0,5,0,2,0,0,0,0,0,0,0,4,6
Campbell1,1,Chris Clemons,FR,G,Campbell,Big South,30,965,186,439,94,193,92,246,92,109,10,101,111,54,45,8,57,75,556
Campbell2,2,Troy Harper,SO,G,Campbell,Big South,30,833,118,306,79,173,39,133,129,168,10,88,98,41,30,5,69,74,404
Campbell3,3,Shane Whitfield,SO,F,Campbell,Big South,30,806,71,123,71,122,0,1,85,116,30,81,111,46,21,2,40,97,227
Campbell4,4,Kyre' Hamer,JR,G,Campbell,Big South,27,790,86,167,65,106,21,61,64,85,11,95,106,53,32,6,49,66,257
Campbell5,5,D.J. Mason,SR,F,Campbell,Big South,30,734,135,274,121,226,14,48,36,73,62,126,188,58,24,12,44,80,320
Campbell6,6,Rod Days,SR,F,Campbell,Big South,30,600,61,119,34,53,27,66,27,41,24,81,105,21,22,10,29,59,176
Campbell7,7,Quinton Ray,JR,G,Campbell,Big South,30,509,13,39,11,22,2,17,8,16,19,28,47,33,18,3,23,38,36
Campbell8,8,Khadre Lane,FR,F,Campbell,Big South,20,263,25,65,16,32,9,33,26,38,16,13,29,13,6,8,10,31,85
Campbell9,9,Andrew Eudy,FR,F,Campbell,Big South,26,217,8,34,6,20,2,14,8,12,18,37,55,11,5,17,12,32,26
Campbell10,10,Curtis Phillips,SO,F,Campbell,Big South,8,208,23,66,15,36,8,30,11,21,4,29,33,13,8,1,7,16,65
Campbell11,11,Casey Perrin,SR,G,Campbell,Big South,9,44,10,21,1,2,9,19,2,2,1,1,2,1,1,0,2,4,31
Campbell12,12,Jon Ander Cuadra,FR,F,Campbell,Big South,7,31,3,9,3,7,0,2,7,9,4,4,8,0,1,0,3,4,13
Campbell13,13,Jacob Talbert,JR,G,Campbell,Big South,6,17,3,7,3,3,0,4,0,0,1,1,2,1,1,0,1,5,6
Campbell14,14,Nick Parker,SO,G,Campbell,Big South,5,9,2,2,1,1,1,1,0,0,1,2,3,0,0,0,0,1,5
Canisius1,1,Malcolm McMillan,SR,G,Canisius,MAAC,33,1132,132,313,91,186,41,127,181,218,17,85,102,135,22,17,60,79,486
Canisius2,2,Kassius Robertson,SO,G,Canisius,MAAC,33,1121,153,350,67,137,86,213,73,100,34,59,93,59,36,2,77,73,465
Canisius3,3,Phil Valenti,JR,F,Canisius,MAAC,33,1036,170,366,123,245,47,121,94,122,60,141,201,65,31,15,51,89,481
Canisius4,4,Kevin Bleeker,SR,C,Canisius,MAAC,33,715,86,190,69,139,17,51,37,49,59,106,165,33,13,30,31,93,226
Canisius5,5,Jermaine Crumpton,SO,F,Canisius,MAAC,30,652,114,268,76,162,38,106,47,68,29,64,93,25,16,7,27,60,313
Canisius6,6,Jamal Reynolds,SR,G,Canisius,MAAC,32,600,55,116,54,114,1,2,56,92,76,80,156,31,23,12,32,58,167
Canisius7,7,Chris Atkinson,FR,G,Canisius,MAAC,33,536,35,139,16,47,19,92,26,35,1,40,41,63,27,0,27,52,115
Canisius8,8,Kiefer Douse,JR,G,Canisius,MAAC,28,346,37,96,33,70,4,26,11,20,16,35,51,28,11,0,21,47,89
Canisius9,9,Isaiah Gurley,FR,G,Canisius,MAAC,30,284,25,77,9,27,16,50,19,25,17,40,57,13,7,2,17,26,85
Canisius10,10,Cassidy Ryan,SO,F,Canisius,MAAC,28,196,29,65,19,41,10,24,4,7,10,21,31,9,7,2,12,36,72
Canisius11,11,Adam Weir,SO,G,Canisius,MAAC,19,114,7,25,2,4,5,21,2,6,5,3,8,5,6,0,2,13,21
Canisius12,12,Ronnie Gombe,SO,F,Canisius,MAAC,13,38,1,6,1,6,0,0,1,2,1,4,5,0,0,1,3,12,3
Canisius13,13,Raven Owen,FR,G,Canisius,MAAC,3,5,1,3,0,0,1,3,0,0,0,0,0,0,0,0,1,2,3
Central Arkansas1,1,Jordan Howard,SO,G,Central Arkansas,Southland,28,976,175,411,80,189,95,222,120,137,18,76,94,78,18,2,61,33,565
Central Arkansas2,2,Derreck Brooks,SR,G,Central Arkansas,Southland,28,869,124,297,87,197,37,100,54,69,54,122,176,73,34,26,53,85,339
Central Arkansas3,3,Justin Foreman,SR,F,Central Arkansas,Southland,28,841,103,244,68,151,35,93,72,125,31,106,137,40,21,2,60,93,313
Central Arkansas4,4,Mathieu Kamba,SO,G,Central Arkansas,Southland,28,717,118,202,116,194,2,8,55,105,61,90,151,36,16,20,63,68,293
Central Arkansas5,5,Jake Zuilhof,SR,C,Central Arkansas,Southland,28,710,69,122,69,122,0,0,39,76,66,121,187,18,10,37,51,102,177
Central Arkansas6,6,Jeff Lowery,JR,G,Central Arkansas,Southland,27,671,62,161,56,143,6,18,59,81,10,45,55,78,27,3,55,63,189
Central Arkansas7,7,Boo Milligan,SO,F,Central Arkansas,Southland,28,258,26,80,19,45,7,35,21,32,10,29,39,21,12,5,17,39,80
Central Arkansas8,8,Albert Christensson,SO,F,Central Arkansas,Southland,27,210,18,40,18,39,0,1,21,43,16,26,42,3,0,3,16,31,57
Central Arkansas9,9,Tanner Schmit,FR,F,Central Arkansas,Southland,26,196,25,58,25,58,0,0,9,14,4,22,26,3,4,6,15,39,59
Central Arkansas10,10,Mike Martin,SR,G,Central Arkansas,Southland,10,152,14,41,11,21,3,20,7,12,2,18,20,19,10,0,8,22,38
Central Connecticut State1,1,Austin Nehls,FR,G,Central Connecticut State,NEC,29,1023,102,273,31,87,71,186,63,81,34,76,110,47,16,6,51,63,338
Central Connecticut State2,2,Brandon Peel,SR,F,Central Connecticut State,NEC,29,862,130,294,130,291,0,3,80,103,89,176,265,59,19,39,56,71,340
Central Connecticut State3,3,Khalen Cumberlander,JR,G,Central Connecticut State,NEC,26,787,99,261,75,162,24,99,58,101,16,80,96,72,27,2,74,61,280
Central Connecticut State4,4,Mustafa Jones,SO,F,Central Connecticut State,NEC,28,580,90,191,90,190,0,1,29,37,34,71,105,28,17,22,32,58,209
Central Connecticut State5,5,Jahlil Nails,FR,G,Central Connecticut State,NEC,27,535,55,140,21,53,34,87,36,46,9,45,54,12,8,1,28,35,180
Central Connecticut State6,6,Kevin Seymour,SO,G,Central Connecticut State,NEC,29,525,51,133,41,103,10,30,13,18,6,41,47,65,10,1,39,23,125
Central Connecticut State7,7,Evan Phoenix,FR,F,Central Connecticut State,NEC,28,409,46,110,46,110,0,0,25,40,43,59,102,11,9,12,34,61,117
Central Connecticut State8,8,JJ Cratit,JR,G,Central Connecticut State,NEC,18,346,44,139,25,84,19,55,26,42,5,21,26,9,7,6,22,30,133
Central Connecticut State9,9,Eric Bowles,FR,G,Central Connecticut State,NEC,20,258,10,33,7,27,3,6,2,9,1,14,15,27,6,0,23,29,25
Central Connecticut State10,10,Tidell Pierre,JR,F,Central Connecticut State,NEC,22,240,17,48,16,47,1,1,12,23,23,34,57,5,2,1,13,30,47
Central Connecticut State11,11,Malik Toppin,FR,F,Central Connecticut State,NEC,23,227,32,59,32,58,0,1,10,19,16,29,45,5,3,17,9,36,74
Central Connecticut State12,12,Shakaris Laney,SO,G,Central Connecticut State,NEC,12,69,6,22,4,11,2,11,5,9,3,7,10,1,3,0,7,7,19
Central Florida1,1,A.J. Davis,SO,G,Central Florida,AAC,30,943,107,280,82,195,25,85,122,155,36,144,180,88,28,15,85,73,361
Central Florida2,2,Daiquan Walker,SR,G,Central Florida,AAC,30,833,81,213,48,124,33,89,52,64,17,85,102,115,33,4,62,44,247
Central Florida3,3,Adonys Henriquez,SO,G,Central Florida,AAC,26,824,86,219,37,82,49,137,41,60,20,60,80,51,15,3,28,24,262
Central Florida4,4,Matt Williams,JR,G,Central Florida,AAC,30,778,81,222,26,55,55,167,25,34,12,67,79,26,13,1,25,46,242
Central Florida5,5,Shaheed Davis,SR,F,Central Florida,AAC,30,581,64,175,43,97,21,78,29,53,37,95,132,20,5,6,47,33,178
Central Florida6,6,Tacko Fall,FR,C,Central Florida,AAC,30,529,96,128,96,128,0,0,29,52,54,122,176,10,3,70,49,75,221
Central Florida7,7,Chance McSpadden,FR,G,Central Florida,AAC,30,484,56,123,41,77,15,46,42,51,9,41,50,46,16,3,50,31,169
Central Florida8,8,Tanksley Efianayi,JR,F,Central Florida,AAC,28,381,33,100,24,56,9,44,31,43,16,29,45,15,14,3,13,28,106
Central Florida9,9,Justin McBride,JR,C,Central Florida,AAC,28,344,72,121,72,121,0,0,39,71,35,74,109,7,5,18,43,61,183
Central Florida10,10,Staphon Blair,SR,F,Central Florida,AAC,28,263,35,64,35,64,0,0,13,31,26,48,74,1,5,13,18,36,83
Central Florida11,11,Chad Brown,FR,F,Central Florida,AAC,15,75,2,11,2,11,0,0,2,5,10,5,15,0,0,3,1,14,6
Central Florida12,12,Djordjije Mumin,SO,G,Central Florida,AAC,6,15,2,7,2,3,0,4,0,0,0,2,2,0,0,0,1,2,4
Central Michigan1,1,John Simons,SR,F,Central Michigan,MAC,32,1117,93,238,21,44,72,194,56,75,52,177,229,28,17,6,29,65,314
Central Michigan2,2,Rayshawn Simmons,SR,G,Central Michigan,MAC,32,1058,142,329,117,243,25,86,84,131,43,95,138,161,18,1,72,88,393
Central Michigan3,3,Braylon Rayson,JR,G,Central Michigan,MAC,31,985,174,419,99,219,75,200,78,95,19,90,109,53,29,0,56,55,501
Central Michigan4,4,Chris Fowler,SR,G,Central Michigan,MAC,25,911,138,304,116,236,22,68,117,146,16,86,102,147,33,3,66,75,415
Central Michigan5,5,Josh Kozinski,SO,G,Central Michigan,MAC,32,714,84,233,5,10,79,223,3,4,12,55,67,14,19,8,5,69,250
Central Michigan6,6,Luke Meyer,SO,F,Central Michigan,MAC,32,689,108,189,98,154,10,35,37,50,56,96,152,8,15,34,15,91,263
Central Michigan7,7,Austin Stewart,SR,G,Central Michigan,MAC,32,439,42,92,33,56,9,36,33,46,21,58,79,9,14,4,16,48,126
Central Michigan8,8,DaRohn Scott,SO,F,Central Michigan,MAC,32,368,41,61,41,61,0,0,17,42,40,61,101,2,4,30,22,79,99
Central Michigan9,9,Corey Redman,FR,G,Central Michigan,MAC,25,105,15,30,0,3,15,27,2,4,13,15,28,2,2,1,2,17,47
Central Michigan10,10,Milos Cabarkapa,SO,C,Central Michigan,MAC,7,15,1,2,1,2,0,0,4,7,1,4,5,1,0,0,0,2,6
Central Michigan11,11,Hunter Hale,FR,G,Central Michigan,MAC,11,13,3,5,1,1,2,4,0,0,0,4,4,1,0,0,1,3,8
Charleston Southern1,1,Armel Potter,FR,G,Charleston Southern,Big South,30,901,146,372,99,237,47,135,75,109,17,79,96,94,26,3,60,51,414
Charleston Southern2,2,Aaron Wheeler,SR,F,Charleston Southern,Big South,30,787,130,260,117,210,13,50,58,109,49,127,176,55,26,24,50,69,331
Charleston Southern3,3,Patrick Wallace,JR,G,Charleston Southern,Big South,30,753,87,238,15,38,72,200,22,25,6,43,49,45,12,0,27,56,268
Charleston Southern4,4,Raemond Robinson,JR,G,Charleston Southern,Big South,30,749,98,241,16,46,82,195,14,20,11,84,95,40,23,1,46,68,292
Charleston Southern5,5,Javis Howard,SO,F,Charleston Southern,Big South,30,739,97,185,94,175,3,10,35,67,54,92,146,20,20,7,49,66,232
Charleston Southern6,6,Demetrius Pollard,SR,G,Charleston Southern,Big South,22,581,69,184,33,66,36,118,30,47,5,47,52,43,7,2,39,43,204
Charleston Southern7,7,Reuben King,SR,F,Charleston Southern,Big South,30,459,58,120,55,102,3,18,18,31,42,76,118,27,15,6,21,58,137
Charleston Southern8,8,Danny Upchurch,SO,G,Charleston Southern,Big South,30,363,28,93,8,21,20,72,13,23,4,38,42,41,8,1,39,31,89
Charleston Southern9,9,Wesley Johnson,SO,C,Charleston Southern,Big South,28,300,16,28,16,28,0,0,22,35,23,30,53,5,8,7,10,49,54
Charleston Southern10,10,Ugo Mmonu,JR,F,Charleston Southern,Big South,18,202,26,43,23,36,3,7,19,26,23,42,65,0,6,7,18,42,74
Charleston Southern11,11,Melvin Brooks,FR,F,Charleston Southern,Big South,18,168,13,29,13,29,0,0,7,10,13,27,40,1,1,5,3,40,33
Charleston Southern12,12,Jabbar Washington,SR,G,Charleston Southern,Big South,8,34,3,10,3,7,0,3,3,6,1,3,4,8,1,0,6,2,9
Charleston Southern13,13,Jantzen Raymond,SO,G,Charleston Southern,Big South,3,8,1,3,0,1,1,2,0,1,0,0,0,0,0,0,2,1,3
Charleston Southern14,14,Zach Durkee,JR,G,Charleston Southern,Big South,2,6,2,2,2,2,0,0,2,3,0,1,1,0,0,0,0,0,6
Charlotte1,1,Braxton Ogbueze,JR,G,Charlotte,CUSA,33,1131,160,383,51,128,109,255,50,66,18,58,76,87,16,2,38,51,479
Charlotte2,2,Jon Davis,FR,G,Charlotte,CUSA,33,1064,135,313,105,229,30,84,86,117,21,73,94,154,40,8,86,72,386
Charlotte3,3,Joseph Uchebo,SR,C,Charlotte,CUSA,33,922,181,310,181,310,0,0,72,130,126,254,380,31,33,22,44,59,434
Charlotte4,4,Andrien White,FR,G,Charlotte,CUSA,33,863,117,283,50,118,67,165,53,79,18,93,111,35,53,6,42,98,354
Charlotte5,5,Curran Scott,FR,G,Charlotte,CUSA,33,815,100,221,75,164,25,57,122,147,11,65,76,44,17,1,55,72,347
Charlotte6,6,Anthony Vanhook,JR,F,Charlotte,CUSA,29,707,89,186,87,181,2,5,34,50,48,74,122,80,26,10,39,77,214
Charlotte7,7,Ridell Camidge,SO,G,Charlotte,CUSA,28,404,40,135,16,40,24,95,9,18,9,45,54,22,7,0,25,31,113
Charlotte8,8,Benas Griciunas,SO,C,Charlotte,CUSA,27,254,44,89,37,75,7,14,11,19,30,44,74,7,4,9,24,39,106
Charlotte9,9,Bernard Sullivan,SR,F,Charlotte,CUSA,10,250,42,105,42,101,0,4,21,36,22,34,56,16,3,9,18,25,105
Charlotte10,10,Reid Aube,JR,F,Charlotte,CUSA,26,182,7,12,7,12,0,0,9,9,15,21,36,2,2,5,6,40,23
Charlotte11,11,Cameron Pappas,SR,G,Charlotte,CUSA,12,64,5,14,3,7,2,7,9,10,0,7,7,3,2,0,3,6,21
Chattanooga1,1,Tre' McLean,JR,F,Chattanooga,Southern,34,1059,149,310,115,216,34,94,86,110,59,159,218,82,55,25,73,77,418
Chattanooga2,2,Greg Pryor,JR,G,Chattanooga,Southern,34,998,88,238,47,110,41,128,119,151,17,61,78,120,50,2,67,91,336
Chattanooga3,3,Eric Robertson,SR,G,Chattanooga,Southern,34,942,97,238,17,40,80,198,26,36,11,38,49,58,28,13,30,66,300
Chattanooga4,4,Chuck Ester,JR,F,Chattanooga,Southern,34,832,103,201,89,167,14,34,42,68,36,130,166,57,34,15,61,60,262
Chattanooga5,5,Justin Tuoyo,JR,F,Chattanooga,Southern,32,807,125,236,123,225,2,11,103,148,68,93,161,32,22,75,41,87,355
Chattanooga6,6,Dee Oldham,SR,G,Chattanooga,Southern,34,657,77,176,50,105,27,71,66,84,41,123,164,38,29,3,39,49,247
Chattanooga7,7,Johnathan Burroughs-Cook,JR,G,Chattanooga,Southern,34,507,68,164,53,111,15,53,52,78,15,46,61,43,20,2,38,53,203
Chattanooga8,8,Duke Ethridge,SR,F,Chattanooga,Southern,31,497,78,164,63,118,15,46,56,73,41,81,122,11,12,15,26,46,227
Chattanooga9,9,Casey Jones,SR,G,Chattanooga,Southern,8,237,41,83,38,72,3,11,16,22,20,32,52,31,4,9,25,15,101
Chattanooga10,10,Peyton Woods,FR,G,Chattanooga,Southern,18,117,15,32,2,3,13,29,8,9,4,9,13,4,5,0,4,16,51
Chattanooga11,11,Alex Bran,SR,G,Chattanooga,Southern,17,89,18,34,5,6,13,28,0,0,1,8,9,9,4,2,7,6,49
Chattanooga12,12,Jackson White,FR,F,Chattanooga,Southern,9,40,3,7,3,6,0,1,3,4,3,5,8,2,0,0,1,6,9
Chattanooga13,13,ZaQwaun Matthews,FR,G,Chattanooga,Southern,9,34,3,11,2,6,1,5,0,2,2,3,5,7,0,0,3,2,7
Chattanooga14,14,K.J. Bates,SO,G,Chattanooga,Southern,7,20,2,6,1,3,1,3,4,7,1,5,6,1,2,0,0,0,9
Chattanooga15,15,Rich Kalina,FR,C,Chattanooga,Southern,4,14,2,4,2,4,0,0,0,1,3,4,7,0,0,2,2,3,4
Chicago State1,1,Trayvon Palmer,JR,F,Chicago State,WAC,30,905,101,239,83,177,18,62,65,89,90,143,233,42,39,30,69,87,285
Chicago State2,2,Fred Sims Jr.,FR,G,Chicago State,WAC,31,643,126,362,86,234,40,128,47,57,26,54,80,27,22,5,33,42,339
Chicago State3,3,Joshua Batson,JR,G,Chicago State,WAC,31,551,24,92,19,64,5,28,14,28,19,43,62,49,19,2,25,60,67
Chicago State4,4,Clemmye Owens,SO,G,Chicago State,WAC,21,530,67,197,36,92,31,105,26,31,10,42,52,38,22,1,30,44,191
Chicago State5,5,Elliott Cole,JR,G,Chicago State,WAC,28,527,87,233,34,76,53,157,24,27,11,37,48,48,25,0,52,44,251
Chicago State6,6,Quron Davis,JR,C,Chicago State,WAC,31,506,40,86,40,86,0,0,35,60,34,71,105,13,6,23,28,87,115
Chicago State7,7,Kieran Woods,SR,G,Chicago State,WAC,22,475,75,177,69,149,6,28,55,92,32,60,92,60,39,8,51,58,211
Chicago State8,8,Jordan Madrid-Andrews,JR,F,Chicago State,WAC,31,461,46,91,45,87,1,4,24,46,46,67,113,10,11,7,37,82,117
Chicago State9,9,Anthony Eaves,FR,G,Chicago State,WAC,29,416,67,163,40,85,27,78,9,12,12,44,56,37,15,3,40,24,170
Chicago State10,10,Jawad Adekoya,SR,F,Chicago State,WAC,22,405,54,146,23,61,31,85,31,44,11,46,57,13,11,1,24,37,170
Chicago State11,11,Montana Byrd,SO,G,Chicago State,WAC,29,310,27,97,14,38,13,59,12,15,19,34,53,10,10,3,17,50,79
Chicago State12,12,Devon Friend,SR,F,Chicago State,WAC,20,304,28,57,28,57,0,0,11,26,23,36,59,4,13,8,23,41,67
Chicago State13,13,Delundre Dixon,FR,G,Chicago State,WAC,25,299,13,36,11,26,2,10,27,37,13,20,33,17,11,5,18,30,55
Chicago State14,14,Jared Dimakos,SR,F,Chicago State,WAC,4,55,8,15,7,11,1,4,2,5,3,9,12,7,2,1,1,10,19
Chicago State15,15,Gentry Hunt,SO,G,Chicago State,WAC,7,13,1,4,1,2,0,2,2,4,0,1,1,0,1,1,1,1,4
Cincinnati1,1,Troy Caupain,JR,G,Cincinnati,AAC,32,1068,140,373,86,205,54,168,88,111,16,102,118,155,37,13,58,46,422
Cincinnati2,2,Gary Clark,SO,F,Cincinnati,AAC,32,983,125,240,112,215,13,25,79,115,113,175,288,69,40,49,42,75,342
Cincinnati3,3,Octavius Ellis,SR,F,Cincinnati,AAC,32,815,116,212,116,212,0,0,87,137,93,152,245,36,26,48,68,92,319
Cincinnati4,4,Farad Cobb,SR,G,Cincinnati,AAC,30,797,115,284,45,106,70,178,21,25,13,41,54,48,41,1,28,34,321
Cincinnati5,5,Jacob Evans,FR,F,Cincinnati,AAC,32,769,84,233,44,107,40,126,44,54,34,92,126,53,27,27,24,57,252
Cincinnati6,6,Kevin Johnson,JR,G,Cincinnati,AAC,32,677,67,193,27,65,40,128,24,32,22,33,55,52,29,2,38,50,198
Cincinnati7,7,Shaq Thomas,SR,F,Cincinnati,AAC,28,573,66,150,55,115,11,35,29,49,40,64,104,39,20,15,34,42,172
Cincinnati8,8,Coreontae DeBerry,SR,C,Cincinnati,AAC,32,462,69,127,69,127,0,0,50,75,39,81,120,6,12,29,18,62,188
Cincinnati9,9,Justin Jenifer,FR,G,Cincinnati,AAC,27,232,21,58,11,28,10,30,14,20,2,16,18,34,14,0,17,18,66
Cincinnati10,10,Quadri Moore,SO,F,Cincinnati,AAC,25,182,18,50,14,39,4,11,13,19,13,21,34,2,8,2,18,19,53
Cincinnati11,11,Zack Tobler,JR,F,Cincinnati,AAC,5,17,2,5,2,5,0,0,5,8,3,0,3,1,0,0,1,3,9
Citadel1,1,Warren Sledge,JR,G,Citadel,Southern,31,879,104,253,39,82,65,171,46,61,21,49,70,73,28,5,47,65,319
Citadel2,2,Derrick Henry,SR,G,Citadel,Southern,32,838,152,355,111,216,41,139,172,218,34,96,130,43,37,0,51,63,517
Citadel3,3,Quinton Marshall,SR,F,Citadel,Southern,32,826,137,305,87,152,50,153,38,57,30,94,124,52,41,6,67,83,362
Citadel4,4,P.J. Boutte,SR,G,Citadel,Southern,31,786,87,208,69,135,18,73,54,82,45,84,129,176,51,1,81,75,246
Citadel5,5,Zane Najdawi,FR,F,Citadel,Southern,32,593,83,180,74,151,9,29,56,73,49,85,134,12,24,58,39,103,231
Citadel6,6,Quayson Williams,FR,G,Citadel,Southern,31,585,98,268,32,85,66,183,26,35,16,44,60,29,28,2,41,74,288
Citadel7,7,Brian White,JR,F,Citadel,Southern,32,535,96,209,71,126,25,83,70,89,32,74,106,11,21,12,37,71,287
Citadel8,8,Tim Broom,SO,G,Citadel,Southern,32,348,28,67,19,41,9,26,18,31,25,16,41,52,17,0,36,81,83
Citadel9,9,Matt Frierson,FR,G,Citadel,Southern,31,307,49,131,9,15,40,116,6,8,11,12,23,18,16,0,9,24,144
Citadel10,10,Connor Schroeder,FR,F,Citadel,Southern,30,305,63,175,25,45,38,130,13,21,22,53,75,15,8,2,8,32,177
Citadel11,11,Tom Koopman,JR,C,Citadel,Southern,31,248,30,53,30,50,0,3,7,12,18,31,49,2,4,12,10,52,67
Citadel12,12,Bobby Duncan,SR,F,Citadel,Southern,21,116,7,12,7,11,0,1,7,15,9,26,35,2,6,0,4,32,21
Citadel13,13,Qwandell Newton,FR,F,Citadel,Southern,15,50,2,15,2,5,0,10,1,2,5,5,10,2,0,1,3,9,5
Citadel14,14,Garrett Mullis,FR,C,Citadel,Southern,1,11,1,2,0,1,1,1,0,0,0,4,4,0,0,0,1,3,3
Citadel15,15,Tommy Olds,JR,G,Citadel,Southern,5,10,1,9,0,6,1,3,0,0,2,3,5,2,0,0,2,3,3
Clemson1,1,Jaron Blossomgame,JR,F,Clemson,ACC,31,1060,201,392,156,290,45,102,133,170,55,151,206,47,23,41,55,63,580
Clemson2,2,Jordan Roper,SR,G,Clemson,ACC,31,1029,96,259,57,144,39,115,42,57,16,67,83,118,40,4,39,39,273
Clemson3,3,Donte Grantham,SO,F,Clemson,ACC,31,1010,108,281,52,123,56,158,44,52,33,92,125,72,31,15,44,61,316
Clemson4,4,Avry Holmes,JR,G,Clemson,ACC,31,959,91,243,41,93,50,150,79,109,17,69,86,80,36,0,41,55,311
Clemson5,5,Landry Nnoko,SR,C,Clemson,ACC,31,691,101,183,101,183,0,0,49,77,67,110,177,26,6,71,48,93,251
Clemson6,6,Gabe DeVoe,SO,G,Clemson,ACC,31,606,57,167,26,64,31,103,18,25,14,72,86,43,14,5,34,55,163
Clemson7,7,Sidy Djitte,JR,C,Clemson,ACC,31,467,62,100,62,100,0,0,40,63,60,102,162,9,19,20,29,88,164
Clemson8,8,Josh Smith,SR,F,Clemson,ACC,26,191,12,34,9,23,3,11,4,5,17,29,46,2,4,2,10,22,31
Clemson9,9,Ty Hudson,FR,G,Clemson,ACC,23,174,19,54,7,19,12,35,5,11,0,9,9,11,5,0,4,19,55
Clemson10,10,Legend Robertin,SO,C,Clemson,ACC,10,44,4,8,4,8,0,0,0,1,2,4,6,0,1,4,2,12,8
Clemson11,11,Riley McGillan,SR,G,Clemson,ACC,6,12,2,4,0,0,2,4,1,2,0,0,0,1,0,0,1,2,7
Cleveland State1,1,Rob Edwards,FR,G,Cleveland State,Horizon,32,994,130,331,81,207,49,124,89,119,21,104,125,46,37,1,109,71,398
Cleveland State2,2,Andre Yates,JR,G,Cleveland State,Horizon,30,850,102,281,70,179,32,102,37,60,24,43,67,63,23,3,56,97,273
Cleveland State3,3,Demonte Flannigan,JR,F,Cleveland State,Horizon,30,697,142,293,135,272,7,21,52,78,45,116,161,23,9,28,49,73,343
Cleveland State4,4,Terrell Hales,SO,G,Cleveland State,Horizon,32,681,21,56,20,43,1,13,8,19,29,45,74,42,33,2,37,70,51
Cleveland State5,5,Kenny Carpenter,SO,G,Cleveland State,Horizon,32,655,86,206,63,134,23,72,23,36,14,75,89,48,21,6,27,38,218
Cleveland State6,6,Vinny Zollo,SR,F,Cleveland State,Horizon,29,642,69,191,47,105,22,86,34,48,52,112,164,32,14,12,44,74,194
Cleveland State7,7,Jibri Blount,FR,F,Cleveland State,Horizon,29,484,59,120,57,116,2,4,44,71,31,60,91,15,25,13,49,64,164
Cleveland State8,8,Nelson Maxwell,FR,G,Cleveland State,Horizon,16,237,12,34,8,28,4,6,13,16,7,16,23,19,8,2,15,34,41
Cleveland State9,9,Jeron Rogers,FR,F,Cleveland State,Horizon,25,228,12,46,7,23,5,23,12,18,9,29,38,7,4,3,11,26,41
Cleveland State10,10,Derek Sloan,SO,F,Cleveland State,Horizon,28,207,12,30,12,30,0,0,12,19,13,21,34,4,4,6,14,44,36
Cleveland State11,11,Tim Hasbargen,SO,G,Cleveland State,Horizon,22,205,19,44,10,21,9,23,11,16,9,19,28,6,8,1,13,16,58
Cleveland State12,12,Daniel Levitt,FR,G,Cleveland State,Horizon,14,193,19,55,3,9,16,46,9,10,6,8,14,3,5,0,3,10,63
Cleveland State13,13,Aaron Scales,JR,C,Cleveland State,Horizon,24,193,10,26,10,26,0,0,12,18,23,12,35,0,3,6,9,39,32
Cleveland State14,14,Myles Hamilton,SR,G,Cleveland State,Horizon,10,122,9,26,6,14,3,12,5,6,5,9,14,19,2,2,12,14,26
Cleveland State15,15,Jonothan Janssen,SO,F,Cleveland State,Horizon,11,37,2,7,1,2,1,5,4,4,3,8,11,0,0,2,0,0,9
Coastal Carolina1,1,Elijah Wilson,JR,G,Coastal Carolina,Big South,29,905,136,348,68,158,68,190,53,77,27,90,117,30,20,5,47,60,393
Coastal Carolina2,2,Shivaughn Wiggins,JR,G,Coastal Carolina,Big South,27,886,101,218,69,138,32,80,124,178,16,65,81,99,40,2,46,49,358
Coastal Carolina3,3,Jaylen Shaw,SO,G,Coastal Carolina,Big South,29,846,128,264,91,175,37,89,31,46,6,61,67,114,24,4,68,61,324
Coastal Carolina4,4,Badou Diagne,SR,F,Coastal Carolina,Big South,26,716,102,233,79,153,23,80,64,86,43,140,183,22,18,24,48,74,291
Coastal Carolina5,5,Tristian Curtis,SR,F,Coastal Carolina,Big South,28,704,74,100,74,100,0,0,31,54,67,124,191,12,15,13,29,77,179
Coastal Carolina6,6,Colton Ray-St Cyr,JR,G,Coastal Carolina,Big South,21,514,62,126,53,94,9,32,47,79,25,95,120,38,22,15,29,48,180
Coastal Carolina7,7,Marcus Freeman,SR,F,Coastal Carolina,Big South,24,385,61,117,61,117,0,0,23,40,62,71,133,5,8,16,20,61,145
Coastal Carolina8,8,Ron Trapps,JR,G,Coastal Carolina,Big South,28,345,54,134,24,47,30,87,13,18,16,28,44,23,10,0,24,21,151
Coastal Carolina9,9,Kevin Holmes Jr.,FR,F,Coastal Carolina,Big South,19,212,17,49,7,13,10,36,2,5,8,31,39,2,5,8,15,14,46
Coastal Carolina10,10,Michel Enanga,SR,F,Coastal Carolina,Big South,10,158,18,37,14,21,4,16,14,21,15,34,49,5,6,3,11,26,54
Coastal Carolina11,11,Christian Adams,FR,G,Coastal Carolina,Big South,13,72,8,21,8,20,0,1,6,10,3,4,7,4,2,0,10,6,22
Coastal Carolina12,12,Aaron Law,SR,G,Coastal Carolina,Big South,13,57,8,22,7,13,1,9,2,2,1,5,6,4,3,0,3,5,19
Coastal Carolina13,13,Josh Coleman,FR,C,Coastal Carolina,Big South,9,27,1,3,1,3,0,0,3,3,4,4,8,0,0,1,3,9,5
Colgate1,1,Austin Tillotson,SR,G,Colgate,Patriot,30,1032,161,370,105,206,56,164,76,95,20,79,99,155,58,1,72,56,454
Colgate2,2,Sean O'Brien,SO,G,Colgate,Patriot,30,841,89,195,43,87,46,108,34,44,18,43,61,72,34,2,19,61,258
Colgate3,3,Jordan Swopshire,SO,F,Colgate,Patriot,30,759,103,224,40,80,63,144,50,66,27,113,140,29,11,6,51,55,319
Colgate4,4,Tom Rivard,SO,F,Colgate,Patriot,30,730,123,253,90,158,33,95,35,57,39,98,137,34,17,17,50,91,314
Colgate5,5,Alex Ramon,SR,G,Colgate,Patriot,30,688,71,155,43,83,28,72,39,55,27,62,89,44,18,6,46,69,209
Colgate6,6,Jordan Robertson,SO,G,Colgate,Patriot,27,453,58,132,35,72,23,60,26,44,22,33,55,12,6,3,21,45,165
Colgate7,7,Malcolm Regisford,FR,F,Colgate,Patriot,21,428,43,94,43,93,0,1,33,57,28,96,124,11,4,12,25,50,119
Colgate8,8,Dave Krmpotich,FR,F,Colgate,Patriot,28,379,48,113,48,111,0,2,27,48,18,39,57,6,7,12,32,54,123
Colgate9,9,Dana Batt,FR,C,Colgate,Patriot,27,371,26,49,26,49,0,0,7,12,23,44,67,6,8,8,15,63,59
Colgate10,10,Francisco Amiel,FR,G,Colgate,Patriot,30,277,12,50,5,13,7,37,5,10,8,15,23,25,18,5,16,29,36
Colgate11,11,David Favorite,FR,G,Colgate,Patriot,12,110,10,32,0,0,10,32,0,0,1,4,5,2,3,0,1,7,30
Colgate12,12,Andrew Bargmann,JR,G,Colgate,Patriot,4,19,3,5,2,2,1,3,0,0,1,1,2,1,0,0,0,1,7
College of Charleston1,1,Cameron Johnson,SO,G,College of Charleston,CAA,31,1026,136,317,81,174,55,143,53,80,23,86,109,73,36,14,64,93,380
College of Charleston2,2,Marquise Pointer,FR,G,College of Charleston,CAA,31,932,116,328,56,150,60,178,56,78,28,45,73,86,37,0,66,61,348
College of Charleston3,3,Payton Hulsey,JR,G,College of Charleston,CAA,31,891,72,156,70,145,2,11,29,54,45,131,176,103,55,5,45,79,175
College of Charleston4,4,Jarrell Brantley,FR,F,College of Charleston,CAA,31,880,133,289,120,250,13,39,82,115,64,163,227,40,40,14,79,99,361
College of Charleston5,5,Evan Bailey,SO,F,College of Charleston,CAA,31,676,64,178,20,51,44,127,27,38,14,38,52,21,18,2,25,63,199
College of Charleston6,6,Nick Harris,FR,F,College of Charleston,CAA,30,588,53,99,53,98,0,1,28,52,44,80,124,10,15,22,24,91,134
College of Charleston7,7,Canyon Barry,JR,G,College of Charleston,CAA,13,415,84,209,56,125,28,84,60,71,6,38,44,17,10,7,31,20,256
College of Charleston8,8,James Bourne,SR,F,College of Charleston,CAA,21,316,25,42,25,41,0,1,21,41,28,23,51,7,3,3,21,44,71
College of Charleston9,9,Terrance O'Donohue,JR,F,College of Charleston,CAA,20,312,26,58,22,49,4,9,12,20,13,56,69,2,6,3,17,43,68
College of Charleston10,10,Donovan Gilmore,SO,F,College of Charleston,CAA,25,183,13,37,13,37,0,0,9,15,13,30,43,1,2,5,13,23,35
Colorado1,1,Josh Scott,SR,F,Colorado,Pac-12,31,943,182,342,179,333,3,9,133,177,84,187,271,58,19,51,40,55,500
Colorado2,2,Wesley Gordon,JR,F,Colorado,Pac-12,33,915,76,184,70,169,6,15,79,112,97,154,251,43,13,66,36,75,237
Colorado3,3,George King,SO,G,Colorado,Pac-12,33,836,150,335,83,188,67,147,89,117,55,103,158,23,13,7,63,58,456
Colorado4,4,Josh Fortune,JR,G,Colorado,Pac-12,33,760,118,295,63,152,55,143,53,75,22,110,132,74,24,6,71,60,344
Colorado5,5,Dominique Collier,SO,G,Colorado,Pac-12,33,745,77,202,37,114,40,88,54,72,9,64,73,88,37,4,68,95,248
Colorado6,6,Xavier Talton,SR,G,Colorado,Pac-12,33,671,47,138,25,79,22,59,39,43,15,66,81,65,25,3,41,69,155
Colorado7,7,Tre'Shaun Fletcher,JR,F,Colorado,Pac-12,33,652,73,187,38,86,35,101,55,66,25,54,79,38,13,6,43,66,236
Colorado8,8,Thomas Akyazili,FR,G,Colorado,Pac-12,32,513,41,121,24,63,17,58,24,35,3,48,51,52,16,8,29,75,123
Colorado9,9,Tory Miller,SO,F,Colorado,Pac-12,32,508,67,143,67,139,0,4,44,72,63,86,149,6,10,12,35,51,178
Colorado10,10,Kenan Guzonjic,SO,F,Colorado,Pac-12,13,53,7,19,5,15,2,4,4,7,6,8,14,1,0,1,6,9,20
Colorado11,11,Brett Brady,SR,G,Colorado,Pac-12,10,19,3,6,1,2,2,4,1,2,0,5,5,0,2,0,2,1,9
Colorado12,12,Josh Repine,SO,G,Colorado,Pac-12,6,8,1,3,0,0,1,3,0,0,0,2,2,2,0,0,0,2,3
Colorado State1,1,Joe De Ciman,SR,G,Colorado State,MWC,34,1112,115,302,48,130,67,172,54,80,47,128,175,58,23,11,49,103,351
Colorado State2,2,John Gillon,JR,G,Colorado State,MWC,34,1079,119,310,59,131,60,179,152,173,14,83,97,131,26,5,77,84,450
Colorado State3,3,Antwan Scott,SR,G,Colorado State,MWC,33,1007,173,406,77,174,96,232,99,130,9,133,142,70,21,2,58,85,541
Colorado State4,4,Dantiel Daniels,SR,F,Colorado State,MWC,34,952,120,194,120,194,0,0,81,142,121,139,260,22,16,27,40,76,321
Colorado State5,5,Emmanuel Omogbo,JR,F,Colorado State,MWC,33,808,130,284,119,234,11,50,88,131,102,162,264,33,14,8,41,76,359
Colorado State6,6,Jeremiah Paige,FR,G,Colorado State,MWC,34,573,53,157,30,86,23,71,39,52,8,53,61,46,12,7,31,58,168
Colorado State7,7,Prentiss Nixon,FR,G,Colorado State,MWC,31,488,49,126,18,44,31,82,19,29,2,51,53,37,4,1,29,67,148
Colorado State8,8,Fred Richardson,SR,G,Colorado State,MWC,26,370,28,78,17,37,11,41,25,35,21,48,69,18,5,1,16,41,92
Colorado State9,9,Gian Clavell,SR,G,Colorado State,MWC,10,369,66,146,39,82,27,64,49,65,18,51,69,31,8,5,19,21,208
Colorado State10,10,Kimani Jackson,SO,F,Colorado State,MWC,25,222,24,56,24,54,0,2,11,22,28,24,52,9,1,10,27,43,59
Colorado State11,11,Toby Van Ry,FR,F,Colorado State,MWC,10,19,1,8,1,5,0,3,1,2,0,2,2,0,1,0,1,3,3
Columbia1,1,Maodo Lo,SR,G,Columbia,Ivy,31,1015,185,411,102,190,83,221,64,91,24,100,124,87,70,11,68,69,517
Columbia2,2,Grant Mullins,SR,G,Columbia,Ivy,31,963,124,268,65,128,59,140,100,120,17,102,119,104,27,4,41,72,407
Columbia3,3,Alex Rosenberg,SR,F,Columbia,Ivy,26,752,114,267,78,165,36,102,96,139,38,66,104,48,19,6,35,62,360
Columbia4,4,Luke Petrasek,JR,F,Columbia,Ivy,31,735,107,215,69,129,38,86,53,66,36,104,140,46,20,36,46,65,305
Columbia5,5,Kyle Castlin,SO,G,Columbia,Ivy,29,514,49,115,42,92,7,23,39,65,28,46,74,22,9,5,25,40,144
Columbia6,6,Jeff Coby,JR,F,Columbia,Ivy,30,469,59,121,52,97,7,24,45,66,48,91,139,16,12,9,19,66,170
Columbia7,7,Isaac Cohen,SR,G,Columbia,Ivy,19,427,30,52,28,47,2,5,0,2,29,50,79,48,10,7,14,33,62
Columbia8,8,Lukas Meisner,FR,F,Columbia,Ivy,29,403,41,92,18,33,23,59,14,21,29,61,90,18,7,15,21,57,119
Columbia9,9,C.J. Davis,FR,G,Columbia,Ivy,30,320,26,77,12,33,14,44,16,22,6,49,55,32,7,3,17,36,82
Columbia10,10,Nate Hickman,SO,G,Columbia,Ivy,29,319,32,69,23,38,9,31,32,49,9,20,29,17,11,0,22,42,105
Columbia11,11,Chris McComber,JR,F,Columbia,Ivy,20,194,15,36,4,4,11,32,2,3,5,15,20,5,1,0,2,27,43
Columbia12,12,John Sica,FR,F,Columbia,Ivy,11,59,4,6,3,5,1,1,1,2,4,6,10,1,2,3,1,9,10
Columbia13,13,Conor Voss,JR,C,Columbia,Ivy,14,52,5,9,5,9,0,0,6,10,7,3,10,0,2,6,4,5,16
Columbia14,14,Kendall Jackson,JR,G,Columbia,Ivy,7,33,3,9,2,3,1,6,2,4,1,1,2,3,1,0,2,9,9
Columbia15,15,Quinton Adlesh,FR,G,Columbia,Ivy,4,15,4,7,2,2,2,5,2,3,1,4,5,3,0,0,0,0,12
Connecticut1,1,Sterling Gibbs,SR,G,Connecticut,AAC,34,1118,118,301,45,112,73,189,100,118,11,63,74,80,31,1,53,51,409
Connecticut2,2,Daniel Hamilton,SO,G,Connecticut,AAC,34,1078,149,385,105,250,44,135,81,95,32,271,303,164,36,14,81,63,423
Connecticut3,3,Rodney Purvis,JR,G,Connecticut,AAC,34,978,150,350,84,180,66,170,59,92,16,83,99,72,29,4,55,66,425
Connecticut4,4,Shonn Miller,SR,F,Connecticut,AAC,34,877,168,286,159,262,9,24,89,112,44,138,182,19,33,29,22,101,434
Connecticut5,5,Jalen Adams,FR,G,Connecticut,AAC,34,794,98,227,88,186,10,41,42,49,27,61,88,83,35,15,57,59,248
Connecticut6,6,Omar Calhoun,SR,G,Connecticut,AAC,34,501,48,117,21,46,27,71,25,31,15,47,62,30,12,8,20,32,148
Connecticut7,7,Amida Brimah,JR,C,Connecticut,AAC,23,484,64,95,64,95,0,0,26,32,42,63,105,2,6,59,19,57,154
Connecticut8,8,Kentan Facey,JR,F,Connecticut,AAC,33,427,46,77,46,77,0,0,15,23,57,66,123,10,7,29,26,70,107
Connecticut9,9,Phillip Nolan,SR,F,Connecticut,AAC,30,312,22,39,22,39,0,0,9,11,16,30,46,4,4,7,13,65,53
Connecticut10,10,Steven Enoch,FR,F,Connecticut,AAC,25,177,19,34,19,34,0,0,6,13,12,27,39,1,0,3,6,33,44
Connecticut11,11,Sam Cassell,JR,G,Connecticut,AAC,17,115,13,36,3,9,10,27,3,3,2,5,7,5,2,1,3,7,39
Connecticut12,12,Nnamdi Amilo,SR,F,Connecticut,AAC,9,15,1,2,1,2,0,0,2,2,0,5,5,0,0,0,0,2,4
Connecticut13,13,Mike Noyes,JR,G,Connecticut,AAC,9,13,2,4,2,4,0,0,0,0,0,1,1,0,0,0,1,2,4
Connecticut14,14,Christian Foxen,SO,F,Connecticut,AAC,9,13,2,5,2,2,0,3,0,0,0,1,1,0,0,0,0,4,4
Coppin State1,1,Christian Kessee,JR,G,Coppin State,MEAC,31,1007,150,385,62,162,88,223,64,80,15,62,77,58,20,0,63,74,452
Coppin State2,2,Terry Harris Jr,JR,F,Coppin State,MEAC,30,912,123,339,105,257,18,82,107,147,67,150,217,29,19,25,53,73,371
Coppin State3,3,Keith Shivers,JR,G,Coppin State,MEAC,27,805,96,236,81,171,15,65,38,60,41,59,100,47,31,3,45,62,245
Coppin State4,4,Trevon Seymore,JR,G,Coppin State,MEAC,24,748,79,230,58,149,21,81,66,91,22,92,114,95,32,7,58,62,245
Coppin State5,5,Joshua Treadwell,JR,F,Coppin State,MEAC,31,699,112,254,73,151,39,103,62,80,36,108,144,35,16,5,46,70,325
Coppin State6,6,James Sylvester,JR,G,Coppin State,MEAC,28,610,81,215,53,150,28,65,91,133,51,50,101,45,25,5,40,55,281
Coppin State7,7,Blake Simpson,SO,F,Coppin State,MEAC,29,567,14,42,14,42,0,0,29,48,48,72,120,10,11,21,24,102,57
Coppin State8,8,Lucian Brownlee,FR,G,Coppin State,MEAC,31,363,39,112,19,53,20,59,32,42,4,23,27,13,7,1,33,40,130
Coppin State9,9,Lawrence Fejokwu,SR,C,Coppin State,MEAC,28,268,9,24,9,23,0,1,10,24,23,33,56,1,4,18,17,58,28
Coppin State10,10,Izais Hicks,JR,F,Coppin State,MEAC,18,151,10,23,10,19,0,4,8,15,12,16,28,6,4,2,7,28,28
Coppin State11,11,Mufaro Murinda,JR,F,Coppin State,MEAC,19,147,18,48,10,20,8,28,9,11,4,12,16,6,2,2,4,11,53
Coppin State12,12,Jerimyjah Batts,JR,F,Coppin State,MEAC,14,90,7,18,7,18,0,0,4,6,14,8,22,2,2,2,6,31,18
Coppin State13,13,Derek Armstrong,FR,G,Coppin State,MEAC,10,33,3,7,2,3,1,4,0,0,2,2,4,1,1,0,0,0,7
Cornell1,1,Matt Morgan,FR,G,Cornell,Ivy,27,829,159,383,89,170,70,213,122,151,11,74,85,53,38,10,52,46,510
Cornell2,2,David Onuorah,JR,F,Cornell,Ivy,28,715,54,107,53,105,1,2,31,77,54,135,189,11,21,45,44,99,140
Cornell3,3,Darryl Smith,JR,G,Cornell,Ivy,28,708,98,151,76,114,22,37,36,50,16,80,96,34,33,12,28,45,254
Cornell4,4,Robert Hatter,JR,G,Cornell,Ivy,24,676,144,347,104,226,40,121,82,116,20,57,77,85,28,3,83,58,410
Cornell5,5,Jordan Abdur-Ra'oof,SO,F,Cornell,Ivy,28,534,42,134,25,66,17,68,12,24,27,65,92,20,22,7,21,58,113
Cornell6,6,Troy Whiteside,FR,G,Cornell,Ivy,28,526,53,144,37,91,16,53,12,23,25,35,60,27,21,0,30,57,134
Cornell7,7,JoJo Fallas,JR,G,Cornell,Ivy,27,442,47,123,14,45,33,78,7,11,1,37,38,26,18,1,14,45,134
Cornell8,8,Wil Bathurst,SO,G,Cornell,Ivy,25,371,38,104,30,74,8,30,12,24,10,49,59,12,12,9,32,44,96
Cornell9,9,Stone Gettings,FR,F,Cornell,Ivy,28,267,22,71,15,37,7,34,9,13,24,27,51,3,4,8,18,52,60
Cornell10,10,Joel Davis,FR,G,Cornell,Ivy,24,228,18,56,12,42,6,14,23,36,15,25,40,12,9,9,20,27,65
Cornell11,11,Robert Mischler,SR,G,Cornell,Ivy,23,151,13,23,2,4,11,19,3,4,1,13,14,6,3,1,6,8,40
Cornell12,12,Desmond Fleming,JR,G,Cornell,Ivy,16,110,12,17,12,16,0,1,2,2,1,8,9,8,4,1,4,18,26
Cornell13,13,Kyle Brown,SO,G,Cornell,Ivy,12,35,2,9,1,1,1,8,1,2,0,4,4,2,3,0,5,3,6
Cornell14,14,Jack Gordon,FR,G,Cornell,Ivy,10,22,1,1,0,0,1,1,0,3,1,2,3,1,0,0,2,0,3
Creighton1,1,Maurice Watson Jr.,JR,G,Creighton,Big East,32,1007,165,350,149,294,16,56,108,150,17,91,108,209,30,0,106,83,454
Creighton2,2,Isaiah Zierden,JR,G,Creighton,Big East,31,984,95,236,25,54,70,182,57,68,8,94,102,69,44,0,29,42,317
Creighton3,3,James Milliken,SR,G,Creighton,Big East,32,820,98,241,53,113,45,128,71,98,10,60,70,53,13,2,26,38,312
Creighton4,4,Cole Huff,JR,F,Creighton,Big East,32,703,124,282,66,127,58,155,61,77,18,137,155,18,21,10,26,72,367
Creighton5,5,Geoffrey Groselle,SR,C,Creighton,Big East,32,667,127,183,127,183,0,0,87,126,74,109,183,14,15,41,45,93,341
Creighton6,6,Toby Hegner,SO,F,Creighton,Big East,30,548,53,151,13,36,40,115,17,28,18,95,113,16,5,11,16,67,163
Creighton7,7,Khyri Thomas,FR,G,Creighton,Big East,31,536,70,146,51,100,19,46,16,37,24,87,111,39,29,2,34,57,175
Creighton8,8,Zach Hanson,JR,F,Creighton,Big East,32,477,87,130,87,130,0,0,40,59,50,49,99,4,7,27,31,93,214
Creighton9,9,Ronnie Harrell,FR,G,Creighton,Big East,26,247,24,72,17,46,7,26,19,30,18,46,64,23,9,1,16,30,74
Creighton10,10,Malik Albert,JR,G,Creighton,Big East,25,206,26,56,25,43,1,13,16,21,4,21,25,27,11,3,17,10,69
Creighton11,11,Tyler Clement,SO,G,Creighton,Big East,27,125,12,27,8,14,4,13,7,12,2,16,18,16,10,0,12,15,35
Creighton12,12,Martin Krampelj,FR,F,Creighton,Big East,7,46,9,19,8,14,1,5,1,6,10,15,25,2,1,3,2,8,20
Creighton13,13,Marlon Stewart,FR,G,Creighton,Big East,11,34,2,11,1,6,1,5,0,0,1,1,2,0,0,0,1,1,5
Dartmouth1,1,Evan Boudreaux,FR,F,Dartmouth,Ivy,27,868,155,341,127,272,28,69,140,169,64,190,254,31,22,7,70,72,478
Dartmouth2,2,Connor Boehm,SR,F,Dartmouth,Ivy,28,786,128,256,111,207,17,49,39,75,69,82,151,58,20,4,46,82,312
Dartmouth3,3,Miles Wright,SO,G,Dartmouth,Ivy,28,774,111,274,74,168,37,106,54,78,44,80,124,23,32,11,45,68,313
Dartmouth4,4,Taylor Johnson,SO,G,Dartmouth,Ivy,25,479,57,109,36,64,21,45,39,43,26,37,63,36,15,3,43,51,174
Dartmouth5,5,Kevin Crescenzi,SR,G,Dartmouth,Ivy,24,450,37,105,23,56,14,49,19,27,19,50,69,44,17,6,21,46,107
Dartmouth6,6,Malik Gill,SR,G,Dartmouth,Ivy,24,419,29,88,18,47,11,41,27,45,3,29,32,66,38,1,48,40,96
Dartmouth7,7,Guilien Smith,FR,G,Dartmouth,Ivy,28,412,49,129,36,84,13,45,29,37,7,30,37,14,11,0,18,35,140
Dartmouth8,8,Cameron Smith,SO,G,Dartmouth,Ivy,27,376,28,77,25,64,3,13,37,53,11,27,38,25,16,3,16,47,96
Dartmouth9,9,Michael Fleming,JR,G,Dartmouth,Ivy,22,269,16,33,9,14,7,19,2,3,6,9,15,15,4,0,19,24,41
Dartmouth10,10,Tommy Carpenter,SR,F,Dartmouth,Ivy,27,242,19,43,19,41,0,2,3,5,10,28,38,30,2,1,19,21,41
Dartmouth11,11,Brandon McDonnell,SR,F,Dartmouth,Ivy,27,224,36,77,34,69,2,8,24,28,14,31,45,7,6,4,14,27,98
Dartmouth12,12,Wesley Dickinson,JR,F,Dartmouth,Ivy,22,96,17,21,17,21,0,0,12,21,10,9,19,1,3,5,4,20,46
Dartmouth13,13,Quinten Payne,JR,G,Dartmouth,Ivy,14,62,4,9,3,4,1,5,0,0,1,5,6,4,1,1,3,10,9
Dartmouth14,14,Matt Rennie,SR,F,Dartmouth,Ivy,14,56,2,6,2,6,0,0,4,7,5,11,16,2,0,0,4,6,8
Dartmouth15,15,Cole Harrison,JR,C,Dartmouth,Ivy,17,56,6,18,6,18,0,0,5,6,7,15,22,3,0,1,4,11,17
Dartmouth16,16,Eli Harrison,JR,F,Dartmouth,Ivy,2,40,1,5,0,4,1,1,0,0,0,5,5,4,3,0,3,2,3
Dartmouth17,17,Ike Ngwudo,JR,F,Dartmouth,Ivy,8,26,3,10,2,5,1,5,1,2,4,3,7,4,0,1,4,4,8
Dartmouth18,18,Michael Stones,FR,G,Dartmouth,Ivy,7,15,2,5,2,4,0,1,1,4,0,1,1,0,2,0,2,3,5
Davidson1,1,Peyton Aldridge,SO,F,Davidson,A-10,32,1105,173,352,128,225,45,127,105,124,67,142,209,70,19,31,46,84,496
Davidson2,2,Brian Sullivan,SR,G,Davidson,A-10,29,1077,132,345,35,108,97,237,54,65,11,96,107,100,27,4,39,48,415
Davidson3,3,Jack Gibbs,JR,G,Davidson,A-10,30,1063,237,546,159,313,78,233,156,186,27,99,126,150,56,2,98,56,708
Davidson4,4,Nathan Ekwu,SO,F,Davidson,A-10,31,622,60,120,59,112,1,8,56,86,64,119,183,25,13,37,25,98,177
Davidson5,5,Jordan Watkins,SO,G,Davidson,A-10,26,570,48,122,13,27,35,95,16,19,15,42,57,27,12,2,21,46,147
Davidson6,6,Oskar Michelsen,SO,F,Davidson,A-10,31,565,39,116,9,19,30,97,25,32,11,50,61,34,7,8,19,49,133
Davidson7,7,Rusty Reigel,SO,G,Davidson,A-10,30,473,23,59,13,26,10,33,12,17,9,49,58,30,2,2,14,48,68
Davidson8,8,Jordan Barham,SR,G,Davidson,A-10,29,409,95,181,93,175,2,6,49,83,29,77,106,22,6,5,16,41,241
Davidson9,9,Andrew McAuliffe,JR,F,Davidson,A-10,31,383,49,87,48,80,1,7,5,17,25,56,81,18,5,7,23,61,104
Davidson10,10,Jake Belford,JR,F,Davidson,A-10,7,131,10,27,5,12,5,15,13,16,9,28,37,6,2,2,6,14,38
Davidson11,11,Kamau Faines,SO,G,Davidson,A-10,4,6,2,4,2,3,0,1,2,3,0,0,0,0,0,0,0,0,6
Dayton1,1,Scoochie Smith,JR,G,Dayton,A-10,32,994,118,268,74,150,44,118,93,138,17,93,110,138,40,4,59,60,373
Dayton2,2,Charles Cooke,JR,G,Dayton,A-10,31,994,159,353,102,213,57,140,111,162,43,144,187,57,38,37,55,61,486
Dayton3,3,Kyle Davis,JR,G,Dayton,A-10,32,827,89,177,69,118,20,59,56,80,13,100,113,69,39,8,41,76,254
Dayton4,4,Dyshawn Pierre,SR,F,Dayton,A-10,21,695,90,200,64,127,26,73,66,78,50,130,180,49,12,4,37,45,272
Dayton5,5,Kendall Pollard,JR,F,Dayton,A-10,26,680,101,202,98,188,3,14,70,123,33,92,125,37,17,11,53,69,275
Dayton6,6,Darrell Davis,SO,G,Dayton,A-10,31,618,67,177,35,70,32,107,21,32,3,73,76,40,11,0,41,52,187
Dayton7,7,Steve McElvene,FR,C,Dayton,A-10,31,569,83,135,83,135,0,0,24,38,56,117,173,15,5,55,43,88,190
Dayton8,8,John Crosby,FR,G,Dayton,A-10,31,287,29,88,23,66,6,22,12,24,4,40,44,30,4,1,25,32,76
Dayton9,9,Sam Miller,FR,F,Dayton,A-10,27,267,28,62,18,29,10,33,21,26,14,23,37,7,7,7,30,52,87
Dayton10,10,Xeyrius Williams,FR,F,Dayton,A-10,26,244,21,46,17,34,4,12,9,12,15,30,45,5,11,10,12,29,55
Dayton11,11,Ryan Mikesell,FR,F,Dayton,A-10,22,176,25,51,14,18,11,33,6,13,10,22,32,17,4,5,10,22,67
Dayton12,12,Bobby Wehrli,SR,F,Dayton,A-10,21,118,8,20,6,10,2,10,2,4,10,7,17,5,1,0,3,23,20
DePaul1,1,Myke Henry,SR,F,DePaul,Big East,31,896,170,317,148,257,22,60,63,87,66,126,192,31,26,8,76,95,425
DePaul2,2,Eli Cain,FR,G,DePaul,Big East,31,877,111,256,80,183,31,73,67,102,17,76,93,55,23,12,62,83,320
DePaul3,3,Billy Garrett,JR,G,DePaul,Big East,30,839,116,294,88,193,28,101,118,144,8,80,88,106,20,8,74,80,378
DePaul4,4,Tommy Hamilton,JR,C,DePaul,Big East,30,720,91,193,65,135,26,58,49,67,34,131,165,25,9,9,52,59,257
DePaul5,5,Aaron Simpson,SR,G,DePaul,Big East,30,718,60,160,23,69,37,91,22,32,16,64,80,49,22,3,34,69,179
DePaul6,6,Darrick Wood,JR,G,DePaul,Big East,29,531,69,193,60,146,9,47,23,33,10,70,80,47,24,5,39,56,170
DePaul7,7,Rashaun Stimage,SR,F,DePaul,Big East,29,514,64,111,64,111,0,0,38,76,57,64,121,2,10,42,31,80,166
DePaul8,8,Erten Gazi,FR,G,DePaul,Big East,30,439,25,56,21,33,4,23,11,16,10,28,38,35,8,2,30,55,65
DePaul9,9,Peter Ryckbosch,JR,F,DePaul,Big East,24,233,14,30,14,30,0,0,9,15,29,30,59,5,4,2,18,45,37
DePaul10,10,R.J. Curington,JR,G,DePaul,Big East,23,191,20,53,9,17,11,36,7,9,18,7,25,5,3,3,15,23,58
DePaul11,11,Joe Hanel,SO,F,DePaul,Big East,18,153,8,16,8,16,0,0,1,4,6,11,17,3,0,0,4,28,17
DePaul12,12,Oumar Barry,FR,F,DePaul,Big East,12,28,1,3,1,3,0,0,0,6,0,2,2,0,0,1,0,2,2
DePaul13,13,Cory Dolins,SR,G,DePaul,Big East,13,18,3,5,3,5,0,0,0,1,2,2,4,0,0,0,0,0,6
Delaware1,1,Kory Holden,SO,G,Delaware,CAA,30,1088,181,458,112,280,69,178,101,127,16,75,91,126,12,2,88,62,532
Delaware2,2,Cazmon Hayes,JR,G,Delaware,CAA,29,1020,112,307,59,123,53,184,51,83,22,129,151,39,29,9,33,52,328
Delaware3,3,Anthony Mosley,SO,G,Delaware,CAA,30,940,90,196,76,167,14,29,98,140,14,119,133,67,21,5,63,87,292
Delaware4,4,Marvin King-Davis,SR,F,Delaware,CAA,29,936,155,348,155,346,0,2,120,162,90,172,262,31,8,17,44,83,430
Delaware5,5,Maurice Jeffers,JR,F,Delaware,CAA,29,660,47,117,47,117,0,0,56,100,53,87,140,15,7,32,58,71,150
Delaware6,6,Devonne Pinkard,JR,G,Delaware,CAA,22,558,37,114,16,40,21,74,19,26,17,63,80,17,7,3,16,55,114
Delaware7,7,Skye Johnson,SO,F,Delaware,CAA,17,264,21,44,21,44,0,0,20,32,24,33,57,4,7,7,26,37,62
Delaware8,8,Barnett Harris,JR,F,Delaware,CAA,27,223,6,13,6,13,0,0,9,18,27,38,65,7,8,10,12,52,21
Delaware9,9,Curtis McRoy,JR,G,Delaware,CAA,27,166,4,18,0,1,4,17,0,0,0,16,16,6,4,0,6,23,12
Delaware10,10,Chivarsky Corbett,SO,G,Delaware,CAA,4,120,14,34,9,13,5,21,3,8,7,16,23,6,3,2,2,8,36
Delaware11,11,Sean Locke,SR,G,Delaware,CAA,12,26,2,10,0,0,2,10,2,3,1,3,4,0,1,0,2,3,8
Delaware State1,1,Devin Morgan Jr.,FR,G,Delaware State,MEAC,31,950,121,331,51,133,70,198,62,78,22,75,97,83,29,0,59,45,374
Delaware State2,2,DeAndre Haywood,JR,G,Delaware State,MEAC,30,773,127,271,109,211,18,60,74,138,25,75,100,72,39,3,63,68,346
Delaware State3,3,Dana Raysor,SO,G,Delaware State,MEAC,30,590,60,171,22,53,38,118,37,54,18,49,67,25,17,2,27,62,195
Delaware State4,4,Kavon Waller,SO,F,Delaware State,MEAC,28,539,54,123,28,61,26,62,25,46,30,46,76,19,7,10,40,50,159
Delaware State5,5,Todd Hughes,SO,G,Delaware State,MEAC,28,463,58,153,53,124,5,29,25,34,15,45,60,20,15,12,37,28,146
Delaware State6,6,Demola Onifade,FR,C,Delaware State,MEAC,28,421,17,46,17,46,0,0,4,10,26,59,85,6,5,30,23,64,38
Delaware State7,7,Joseph Lewis,JR,F,Delaware State,MEAC,29,401,51,121,44,99,7,22,21,40,21,70,91,23,18,8,32,61,130
Delaware State8,8,DeVaughn Mallory,FR,F,Delaware State,MEAC,29,389,44,100,43,92,1,8,12,19,34,36,70,6,4,8,27,54,101
Delaware State9,9,Aric Dickerson,SR,G,Delaware State,MEAC,27,365,40,96,7,18,33,78,8,12,6,16,22,15,3,1,17,18,121
Delaware State10,10,Artem Tavakalyan,SO,F,Delaware State,MEAC,29,333,34,96,27,69,7,27,13,23,13,36,49,26,10,2,21,47,88
Delaware State11,11,Mrdjan Gasevic,JR,F,Delaware State,MEAC,28,284,27,69,27,69,0,0,17,32,26,41,67,16,4,6,20,36,71
Delaware State12,12,Jason Owens,SR,F,Delaware State,MEAC,23,259,19,59,18,57,1,2,11,19,10,42,52,11,6,8,17,41,50
Delaware State13,13,Scott Sill,JR,F,Delaware State,MEAC,15,246,28,79,15,31,13,48,1,4,12,33,45,3,3,2,10,19,70
Delaware State14,14,Cahli Thomas,JR,G,Delaware State,MEAC,23,237,10,38,4,11,6,27,12,14,2,18,20,24,5,0,17,20,38
Delaware State15,15,Malik Carter,SO,G,Delaware State,MEAC,9,106,9,36,7,24,2,12,6,10,5,10,15,13,4,1,12,12,26
Delaware State16,16,Mahir Johnson,FR,G,Delaware State,MEAC,10,80,11,26,8,19,3,7,2,3,4,4,8,3,3,0,6,9,27
Denver1,1,Joe Rosga,FR,G,Denver,Summit,29,964,115,240,78,145,37,95,100,113,17,54,71,65,41,1,50,53,367
Denver2,2,Thomas Neff,FR,G,Denver,Summit,31,873,63,148,25,58,38,90,23,36,20,64,84,46,26,7,42,79,187
Denver3,3,Marcus Byrd,SR,F,Denver,Summit,31,859,125,252,74,129,51,123,35,44,14,103,117,47,20,21,40,93,336
Denver4,4,Jake Pemberton,SO,G,Denver,Summit,31,845,45,99,32,54,13,45,42,50,9,76,85,84,45,5,54,64,145
Denver5,5,Nate Engesser,SR,G,Denver,Summit,31,656,117,226,63,100,54,126,56,67,9,62,71,37,16,4,33,41,344
Denver6,6,C.J. Bobbitt,FR,F,Denver,Summit,24,537,70,156,63,125,7,31,54,82,22,69,91,41,17,6,53,72,201
Denver7,7,Bryant Rucker,SR,G,Denver,Summit,31,509,56,109,35,61,21,48,35,44,2,31,33,47,15,1,31,30,168
Denver8,8,Christian Mackey,SO,C,Denver,Summit,31,379,46,101,41,83,5,18,38,54,31,50,81,41,11,17,39,73,135
Denver9,9,Duke Douglas,SO,G,Denver,Summit,29,286,28,55,24,42,4,13,7,11,10,42,52,13,3,8,7,45,67
Denver10,10,Jake Holtzmann,FR,G,Denver,Summit,24,219,12,40,7,17,5,23,15,19,7,17,24,18,3,1,14,20,44
Denver11,11,Daniel Amigo,SO,C,Denver,Summit,13,71,12,22,12,22,0,0,3,10,3,14,17,4,1,0,13,23,27
Detroit Mercy1,1,Anton Wilson,SR,G,Detroit Mercy,Horizon,31,1001,137,314,51,113,86,201,83,93,28,94,122,68,41,19,54,91,443
Detroit Mercy2,2,Chris Jenkins,JR,G,Detroit Mercy,Horizon,31,986,117,246,66,128,51,118,88,114,30,146,176,42,31,14,45,82,373
Detroit Mercy3,3,Paris Bass,SO,G,Detroit Mercy,Horizon,24,714,159,342,137,274,22,68,102,149,50,141,191,50,33,33,81,84,442
Detroit Mercy4,4,Jaleel Hogan,SO,F,Detroit Mercy,Horizon,31,690,132,229,132,229,0,0,60,106,65,63,128,28,17,23,56,112,324
Detroit Mercy5,5,Josh McFolley,FR,G,Detroit Mercy,Horizon,30,657,83,219,40,92,43,127,47,71,10,35,45,68,35,2,46,72,256
Detroit Mercy6,6,Carlton Brundidge,SR,G,Detroit Mercy,Horizon,31,632,118,238,108,202,10,36,81,110,48,78,126,70,20,3,41,60,327
Detroit Mercy7,7,Gerald Blackshear,FR,F,Detroit Mercy,Horizon,31,469,48,87,48,87,0,0,30,54,54,71,125,9,10,16,26,80,126
Detroit Mercy8,8,Jarod Williams,JR,G,Detroit Mercy,Horizon,31,377,42,100,31,68,11,32,34,52,9,47,56,41,12,4,34,39,129
Detroit Mercy9,9,Matthew Grant,JR,G,Detroit Mercy,Horizon,26,331,17,63,9,29,8,34,16,19,3,31,34,23,9,4,12,32,58
Detroit Mercy10,10,Aaron Foster-Smith,FR,F,Detroit Mercy,Horizon,30,321,43,80,31,50,12,30,9,17,19,36,55,8,5,9,14,48,107
Detroit Mercy11,11,Jalen Gibson,FR,F,Detroit Mercy,Horizon,5,32,1,7,1,6,0,1,5,10,3,9,12,0,0,6,4,6,7
Detroit Mercy12,12,Patrick Robinson Jr.,JR,G,Detroit Mercy,Horizon,7,15,1,4,0,0,1,4,0,0,0,2,2,1,0,0,2,1,3
Drake1,1,Reed Timmer,SO,G,Drake,MVC,31,1025,166,359,126,260,40,99,148,182,13,99,112,78,19,0,75,61,520
Drake2,2,Graham Woodward,SO,G,Drake,MVC,31,927,113,285,53,142,60,143,50,73,4,37,41,89,23,0,78,64,336
Drake3,3,Kale Abrahamson,JR,F,Drake,MVC,30,830,111,284,57,126,54,158,58,85,25,91,116,28,11,4,41,63,334
Drake4,4,Ore Arogundade,SO,G,Drake,MVC,31,736,67,163,44,100,23,63,23,30,15,124,139,23,26,4,28,55,180
Drake5,5,Jacob Enevold,JR,C,Drake,MVC,29,494,51,90,51,90,0,0,42,51,43,99,142,10,3,13,32,52,144
Drake6,6,Dominik Olejniczak,FR,C,Drake,MVC,30,491,83,115,83,115,0,0,30,44,36,88,124,10,6,21,36,61,196
Drake7,7,Karl Madison,SR,G,Drake,MVC,30,433,19,57,16,43,3,14,6,8,4,21,25,49,5,0,38,45,47
Drake8,8,Casey Schlatter,FR,F,Drake,MVC,31,404,34,89,31,77,3,12,18,35,29,47,76,36,5,4,19,41,89
Drake9,9,C.J. Rivers,SO,G,Drake,MVC,17,338,26,48,22,39,4,9,5,11,9,53,62,33,9,0,18,22,61
Drake10,10,Nick McGlynn,FR,F,Drake,MVC,30,305,25,53,25,53,0,0,22,35,21,57,78,10,4,15,19,56,72
Drake11,11,Billy Wampler,FR,F,Drake,MVC,29,289,39,94,12,34,27,60,4,8,1,25,26,12,5,4,15,37,109
Drake12,12,A.J. Rutter,SO,G,Drake,MVC,1,3,2,2,1,1,1,1,0,0,0,0,0,0,0,0,0,2,5
Drexel1,1,Terrell Allen,FR,G,Drexel,CAA,31,1007,94,234,77,179,17,55,98,117,16,74,90,100,49,3,58,88,303
Drexel2,2,Tavon Allen,SR,G,Drexel,CAA,31,939,134,365,62,170,72,195,67,81,11,79,90,72,20,16,50,95,407
Drexel3,3,Rashann London,SO,G,Drexel,CAA,31,934,84,244,55,140,29,104,35,50,21,50,71,71,12,1,48,64,232
Drexel4,4,Kazembe Abif,SR,F,Drexel,CAA,31,926,111,238,110,229,1,9,64,103,68,149,217,26,13,10,40,104,287
Drexel5,5,Sammy Mojica,SO,G,Drexel,CAA,31,880,98,279,50,137,48,142,33,53,34,74,108,63,25,19,51,86,277
Drexel6,6,Rodney Williams,JR,F,Drexel,CAA,30,785,107,234,107,234,0,0,102,151,62,105,167,37,11,32,45,106,316
Drexel7,7,Mohamed Bah,JR,F,Drexel,CAA,26,341,22,51,22,50,0,1,15,32,19,56,75,8,7,11,18,52,59
Drexel8,8,Tyshawn Myles,SO,F,Drexel,CAA,23,215,14,32,14,32,0,0,9,27,27,30,57,2,4,10,10,37,37
Drexel9,9,Austin Williams,SO,F,Drexel,CAA,18,132,6,17,6,17,0,0,5,10,11,28,39,2,0,6,7,28,17
Drexel10,10,Ahmad Fields,SO,G,Drexel,CAA,3,47,6,21,4,16,2,5,4,6,3,13,16,1,0,0,4,12,18
Drexel11,11,Andrew Cartwright,FR,F,Drexel,CAA,6,12,1,5,0,0,1,5,2,2,0,2,2,1,0,0,1,3,5
Duke1,1,Grayson Allen,SO,G,Duke,ACC,33,1197,221,473,138,274,83,199,187,224,22,125,147,118,46,5,65,91,712
Duke2,2,Brandon Ingram,FR,G,Duke,ACC,33,1127,191,433,117,254,74,179,99,144,64,162,226,64,37,46,69,69,555
Duke3,3,Matt Jones,JR,G,Duke,ACC,32,1040,118,288,46,115,72,173,37,51,33,49,82,76,34,7,34,78,345
Duke4,4,Marshall Plumlee,SR,C,Duke,ACC,33,1009,93,139,93,139,0,0,83,145,114,171,285,36,26,49,35,88,269
Duke5,5,Derryck Thornton,FR,G,Duke,ACC,33,865,90,233,63,153,27,80,39,55,10,53,63,80,26,7,53,71,246
Duke6,6,Luke Kennard,FR,G,Duke,ACC,33,861,129,306,79,148,50,158,86,97,29,78,107,52,29,3,25,62,394
Duke7,7,Amile Jefferson,SR,F,Duke,ACC,9,273,41,60,41,60,0,0,21,38,43,50,93,13,9,10,15,23,103
Duke8,8,Chase Jeter,FR,F,Duke,ACC,29,226,19,35,19,35,0,0,17,32,23,31,54,4,3,7,19,54,55
Duke9,9,Sean Obi,SO,F,Duke,ACC,10,27,1,2,1,2,0,0,3,6,6,4,10,0,0,1,2,8,5
Duke10,10,Antonio Vrankovic,FR,C,Duke,ACC,5,14,2,2,2,2,0,0,0,0,2,5,7,0,1,1,3,3,4
Duquesne1,1,Derrick Colter,SR,G,Duquesne,A-10,32,1143,183,451,107,231,76,220,123,152,15,96,111,143,33,5,102,64,565
Duquesne2,2,Micah Mason,SR,G,Duquesne,A-10,31,1111,193,412,83,154,110,258,72,87,6,88,94,142,31,2,61,56,568
Duquesne3,3,L.G. Gill,JR,F,Duquesne,A-10,32,959,116,270,66,122,50,148,38,51,47,159,206,29,7,21,36,94,320
Duquesne4,4,Eric James,SO,G,Duquesne,A-10,32,820,109,234,92,164,17,70,54,82,53,115,168,44,36,10,65,67,289
Duquesne5,5,Darius Lewis,JR,C,Duquesne,A-10,32,666,79,137,79,137,0,0,45,85,48,144,192,21,7,44,53,106,203
Duquesne6,6,TySean Powell,SO,F,Duquesne,A-10,26,436,68,116,66,113,2,3,25,43,37,91,128,33,13,19,41,60,163
Duquesne7,7,Jeremiah Jones,SR,G,Duquesne,A-10,12,311,39,76,27,45,12,31,25,38,15,31,46,31,8,0,18,25,115
Duquesne8,8,Nakye Sanders,FR,F,Duquesne,A-10,28,234,19,30,19,30,0,0,11,31,22,55,77,12,6,13,14,59,49
Duquesne9,9,Mar'Qywell Jackson,FR,G,Duquesne,A-10,23,231,26,72,9,21,17,51,13,18,12,31,43,7,4,2,9,32,82
Duquesne10,10,Josh Steel,FR,G,Duquesne,A-10,27,217,18,43,5,16,13,27,4,6,4,18,22,18,5,0,13,27,53
Duquesne11,11,Jordan Robinson,SO,F,Duquesne,A-10,21,159,24,46,24,46,0,0,9,17,19,32,51,5,1,5,10,28,57
Duquesne12,12,Rene Castro,SO,G,Duquesne,A-10,17,130,15,48,11,28,4,20,10,16,3,7,10,10,2,0,15,12,44
Duquesne13,13,Nick Foschia,SR,F,Duquesne,A-10,11,19,1,8,1,6,0,2,0,0,3,5,8,1,0,0,1,2,2
Duquesne14,14,David Haus,SO,G,Duquesne,A-10,9,12,1,1,1,1,0,0,0,0,0,3,3,0,0,0,0,2,2
East Carolina1,1,B.J. Tyson,SO,G,East Carolina,AAC,32,1071,173,412,129,262,44,150,78,106,25,116,141,82,31,4,73,55,468
East Carolina2,2,Caleb White,JR,G,East Carolina,AAC,30,962,128,302,58,118,70,184,48,60,13,81,94,75,23,3,53,57,374
East Carolina3,3,Prince Williams,SR,G,East Carolina,AAC,32,903,113,265,74,169,39,96,63,84,20,80,100,123,37,7,67,53,328
East Carolina4,4,Kentrell Barkley,FR,G,East Carolina,AAC,31,872,98,211,74,143,24,68,93,137,53,142,195,93,38,11,48,50,313
East Carolina5,5,Michael Zangari,SR,F,East Carolina,AAC,31,662,59,147,46,96,13,51,50,68,47,72,119,23,10,6,28,85,181
East Carolina6,6,Michel Nzege,JR,F,East Carolina,AAC,29,521,48,93,48,93,0,0,33,41,48,58,106,17,10,12,30,52,129
East Carolina7,7,Lance Tejada,SO,G,East Carolina,AAC,31,463,35,120,8,39,27,81,38,60,3,28,31,38,16,1,30,50,135
East Carolina8,8,Clarence Williams,JR,F,East Carolina,AAC,31,401,42,94,38,79,4,15,7,10,23,62,85,13,13,10,34,48,95
East Carolina9,9,Kanu Aja,SR,F,East Carolina,AAC,30,397,36,77,36,76,0,1,15,41,29,58,87,9,1,7,16,52,87
East Carolina10,10,Charles Foster,JR,G,East Carolina,AAC,21,116,17,39,8,12,9,27,3,6,1,7,8,6,1,0,13,12,46
East Carolina11,11,Grant Bryant,SO,F,East Carolina,AAC,13,91,10,17,10,17,0,0,4,7,5,8,13,2,2,1,4,15,24
East Carolina12,12,Deng Riak,FR,C,East Carolina,AAC,8,45,1,8,0,3,1,5,0,0,2,6,8,2,1,2,3,7,3
East Carolina13,13,Drew Bost,SR,G,East Carolina,AAC,7,14,1,5,0,0,1,5,0,0,0,1,1,2,0,0,0,0,3
East Tennessee State1,1,T.J. Cromer,JR,G,East Tennessee State,Southern,34,1095,172,395,106,218,66,177,99,124,24,89,113,105,33,1,68,88,509
East Tennessee State2,2,Ge'Lawn Guyn,SR,G,East Tennessee State,Southern,33,1069,203,472,116,264,87,208,106,141,17,105,122,55,34,27,66,70,599
East Tennessee State3,3,Isaac Banks,JR,F,East Tennessee State,Southern,34,806,89,148,89,148,0,0,38,77,75,137,212,17,9,20,39,88,216
East Tennessee State4,4,Deuce Bello,SR,G,East Tennessee State,Southern,34,734,107,226,80,141,27,85,78,116,32,81,113,36,39,16,60,97,319
East Tennessee State5,5,Desonta Bradford,SO,G,East Tennessee State,Southern,34,679,86,173,69,131,17,42,61,76,28,70,98,66,34,13,34,65,250
East Tennessee State6,6,Petey McClain,SR,G,East Tennessee State,Southern,34,674,31,79,24,48,7,31,16,28,14,63,77,90,33,3,44,75,85
East Tennessee State7,7,Lester Wilson,SR,F,East Tennessee State,Southern,33,559,70,178,12,37,58,141,23,32,23,69,92,18,13,2,18,59,221
East Tennessee State8,8,Peter Jurkin,JR,C,East Tennessee State,Southern,34,397,66,117,66,116,0,1,45,58,36,64,100,0,10,30,33,53,177
East Tennessee State9,9,A.J. Merriweather,JR,G,East Tennessee State,Southern,19,343,46,92,39,73,7,19,31,41,19,48,67,15,15,1,24,34,130
East Tennessee State10,10,Abednego Lufile,JR,F,East Tennessee State,Southern,29,315,37,80,37,74,0,6,23,34,25,62,87,9,7,6,19,20,97
East Tennessee State11,11,Nigel Holley,JR,F,East Tennessee State,Southern,18,124,10,20,10,20,0,0,4,7,5,12,17,5,0,1,8,22,24
East Tennessee State12,12,Toriano Stokes,FR,C,East Tennessee State,Southern,11,47,4,8,4,8,0,0,1,4,5,6,11,0,0,6,1,6,9
East Tennessee State13,13,Stetson Moore,JR,G,East Tennessee State,Southern,9,33,3,10,1,2,2,8,0,0,1,1,2,1,2,0,0,7,8
Eastern Illinois1,1,Cornell Johnston,SO,G,Eastern Illinois,OVC,30,1131,103,278,39,108,64,170,61,94,23,64,87,171,36,1,58,60,331
Eastern Illinois2,2,Casey Teson,FR,G,Eastern Illinois,OVC,30,848,74,198,10,32,64,166,14,18,4,66,70,21,16,2,19,39,226
Eastern Illinois3,3,Trae Anderson,SR,G,Eastern Illinois,OVC,30,711,171,357,166,325,5,32,94,141,46,110,156,53,31,22,85,91,441
Eastern Illinois4,4,Demetrius McReynolds,JR,G,Eastern Illinois,OVC,27,674,115,248,64,112,51,136,45,55,33,104,137,36,22,2,24,52,326
Eastern Illinois5,5,A.J. Riley,JR,G,Eastern Illinois,OVC,30,629,93,224,73,160,20,64,90,128,39,62,101,60,23,4,64,68,296
Eastern Illinois6,6,Patrick Muldoon,FR,F,Eastern Illinois,OVC,30,497,58,117,58,116,0,1,19,36,27,63,90,16,12,2,30,96,135
Eastern Illinois7,7,Joe Kuligoski,SR,F,Eastern Illinois,OVC,29,401,31,71,24,41,7,30,12,18,26,50,76,17,12,5,11,55,81
Eastern Illinois8,8,Marshawn Blackmon,FR,F,Eastern Illinois,OVC,30,357,48,78,47,75,1,3,10,36,37,49,86,10,17,6,22,33,107
Eastern Illinois9,9,Lucas Jones,FR,F,Eastern Illinois,OVC,19,238,22,54,14,28,8,26,3,5,13,24,37,5,3,2,8,18,55
Eastern Illinois10,10,Luke Norman,SR,G,Eastern Illinois,OVC,25,213,10,21,3,5,7,16,7,11,0,19,19,8,0,0,7,17,34
Eastern Illinois11,11,Luke Piotrowski,SR,F,Eastern Illinois,OVC,21,171,21,38,21,38,0,0,18,24,13,27,40,4,0,13,6,23,60
Eastern Illinois12,12,Anthony Johnson,JR,G,Eastern Illinois,OVC,18,133,13,34,9,23,4,11,8,11,2,16,18,6,2,0,4,16,38
Eastern Illinois13,13,Aboubacar Diallo,FR,F,Eastern Illinois,OVC,15,65,3,7,3,7,0,0,0,3,6,6,12,5,2,8,3,13,6
Eastern Illinois14,14,Aleksa Novakovic,FR,F,Eastern Illinois,OVC,8,26,1,11,0,2,1,9,2,3,2,5,7,4,0,0,4,1,5
Eastern Illinois15,15,Justin Earls,SO,F,Eastern Illinois,OVC,2,6,1,1,1,1,0,0,2,4,2,0,2,1,1,1,0,1,4
Eastern Kentucky1,1,Jarelle Reischel,SR,G,Eastern Kentucky,OVC,30,941,165,339,125,234,40,105,167,213,38,166,204,96,50,13,124,88,537
Eastern Kentucky2,2,Nick Mayo,FR,F,Eastern Kentucky,OVC,31,923,179,295,164,268,15,27,77,96,48,105,153,34,20,34,63,71,450
Eastern Kentucky3,3,Isaac McGlone,JR,G,Eastern Kentucky,OVC,31,877,46,116,7,20,39,96,11,15,5,49,54,57,39,3,10,75,142
Eastern Kentucky4,4,Javontae Hawkins,JR,G,Eastern Kentucky,OVC,30,866,182,363,149,264,33,99,114,149,40,103,143,63,29,13,82,95,511
Eastern Kentucky5,5,Paul Jackson,SO,G,Eastern Kentucky,OVC,30,816,65,144,41,87,24,57,60,90,16,43,59,149,25,3,67,92,214
Eastern Kentucky6,6,Ja'Mill Powell,SR,G,Eastern Kentucky,OVC,27,427,49,120,26,56,23,64,32,42,21,36,57,17,13,6,22,59,153
Eastern Kentucky7,7,Jaylen Babb-Harrison,JR,G,Eastern Kentucky,OVC,30,381,57,127,14,32,43,95,16,19,10,52,62,24,14,2,13,30,173
Eastern Kentucky8,8,Anthony Pratt,FR,F,Eastern Kentucky,OVC,29,304,34,52,34,51,0,1,13,28,23,50,73,10,3,12,18,60,81
Eastern Kentucky9,9,Greg King,SO,F,Eastern Kentucky,OVC,23,215,29,62,29,62,0,0,11,30,19,42,61,7,3,7,29,37,69
Eastern Kentucky10,10,K.J. Bluford,SR,G,Eastern Kentucky,OVC,13,178,29,79,3,5,26,74,5,10,4,11,15,7,6,2,8,25,89
Eastern Kentucky11,11,Dujuanta Weaver,FR,G,Eastern Kentucky,OVC,16,165,14,33,9,17,5,16,1,2,5,16,21,28,10,0,10,16,34
Eastern Kentucky12,12,Jonathan Hood,SR,G,Eastern Kentucky,OVC,7,60,8,15,2,4,6,11,3,4,0,4,4,0,3,0,1,5,25
Eastern Kentucky13,13,Tommy Matthews,SR,G,Eastern Kentucky,OVC,23,36,4,11,1,5,3,6,0,1,5,8,13,3,1,0,2,11,11
Eastern Kentucky14,14,Daniel Parke,SO,G,Eastern Kentucky,OVC,5,9,2,3,1,1,1,2,1,1,0,0,0,0,1,0,0,1,6
Eastern Kentucky15,15,Kirkland Humphrey,FR,G,Eastern Kentucky,OVC,2,2,1,1,1,1,0,0,0,0,0,0,0,0,1,0,0,0,2
Eastern Michigan1,1,James Thompson IV,FR,C,Eastern Michigan,MAC,33,1058,182,281,182,280,0,1,126,184,148,203,351,20,25,47,48,117,490
Eastern Michigan2,2,Tim Bond,SO,G,Eastern Michigan,MAC,33,1018,110,249,93,186,17,63,55,71,37,101,138,94,66,23,63,94,292
Eastern Michigan3,3,Ty Toney,JR,G,Eastern Michigan,MAC,31,935,113,286,98,220,15,66,100,138,15,83,98,89,49,9,79,77,341
Eastern Michigan4,4,Brandon Nazione,SR,F,Eastern Michigan,MAC,33,891,110,203,99,181,11,22,85,115,59,153,212,36,37,13,50,90,316
Eastern Michigan5,5,Willie Mangum,JR,G,Eastern Michigan,MAC,33,810,139,361,74,181,65,180,53,77,10,59,69,54,40,2,68,76,396
Eastern Michigan6,6,Raven Lee,JR,G,Eastern Michigan,MAC,27,641,116,280,68,148,48,132,128,156,12,28,40,43,36,2,58,54,408
Eastern Michigan7,7,Jodan Price,JR,F,Eastern Michigan,MAC,29,448,40,117,14,31,26,86,16,26,6,34,40,8,17,10,16,43,122
Eastern Michigan8,8,Jordan Nobles,FR,F,Eastern Michigan,MAC,30,328,25,48,25,46,0,2,14,25,24,47,71,6,13,10,5,55,64
Eastern Michigan9,9,Ethan Alvano,SO,G,Eastern Michigan,MAC,21,179,16,56,15,38,1,18,25,34,3,13,16,17,16,0,11,21,58
Eastern Michigan10,10,Trent Perry,SO,G,Eastern Michigan,MAC,19,126,6,35,2,7,4,28,2,4,1,5,6,4,3,0,2,10,18
Eastern Michigan11,11,Jordan Martin,SR,G,Eastern Michigan,MAC,16,102,9,26,9,25,0,1,9,17,13,19,32,3,5,4,4,19,27
Eastern Michigan12,12,Blake Brown,FR,F,Eastern Michigan,MAC,17,79,6,9,6,9,0,0,1,3,9,9,18,0,2,2,2,15,13
Eastern Michigan13,13,LaMonta Stone II,FR,G,Eastern Michigan,MAC,6,35,3,10,3,7,0,3,2,4,1,2,3,5,3,0,7,3,8
Eastern Washington1,1,Austin McBroom,SR,G,Eastern Washington,Big Sky,31,1155,197,452,89,188,108,264,149,180,17,56,73,110,35,0,90,51,651
Eastern Washington2,2,Venky Jois,SR,F,Eastern Washington,Big Sky,31,1048,218,319,218,319,0,0,83,179,58,217,275,77,32,55,82,78,519
Eastern Washington3,3,Bogdan Bliznyuk,SO,F,Eastern Washington,Big Sky,32,1044,138,308,98,193,40,115,75,95,53,163,216,93,39,22,79,101,391
Eastern Washington4,4,Felix Von Hofe,JR,F,Eastern Washington,Big Sky,31,1003,130,300,35,69,95,231,40,52,14,90,104,31,17,13,25,62,395
Eastern Washington5,5,Sir Washington,SO,G,Eastern Washington,Big Sky,31,542,60,118,52,84,8,34,49,71,32,51,83,25,20,3,23,71,177
Eastern Washington6,6,Julian Harrell,JR,G,Eastern Washington,Big Sky,19,415,57,111,36,55,21,56,24,39,13,40,53,20,13,7,19,61,159
Eastern Washington7,7,Jesse Hunt,FR,F,Eastern Washington,Big Sky,28,258,21,44,17,28,4,16,3,6,25,25,50,9,8,7,7,46,49
Eastern Washington8,8,Ty Gibson,FR,G,Eastern Washington,Big Sky,25,183,13,37,3,5,10,32,7,11,5,10,15,13,4,0,6,18,43
Eastern Washington9,9,Cody Benzel,FR,G,Eastern Washington,Big Sky,31,181,37,86,6,9,31,77,3,4,3,12,15,7,6,3,4,19,108
Eastern Washington10,10,Will Ferris,FR,G,Eastern Washington,Big Sky,29,174,11,33,3,9,8,24,9,9,5,10,15,17,3,1,12,34,39
Eastern Washington11,11,Bear Henderson,FR,F,Eastern Washington,Big Sky,28,150,12,23,10,19,2,4,14,21,9,9,18,6,4,1,8,29,40
Eastern Washington12,12,Kyle Reid,SR,F,Eastern Washington,Big Sky,26,128,11,16,11,16,0,0,11,18,9,17,26,5,5,5,3,33,33
Eastern Washington13,13,Enrico Nuno,SO,F,Eastern Washington,Big Sky,17,108,3,12,1,4,2,8,2,3,11,18,29,7,8,5,4,23,10
Eastern Washington14,14,Michael Wearne,FR,G,Eastern Washington,Big Sky,1,11,3,3,3,3,0,0,0,0,1,1,2,4,1,0,0,1,6
Elon1,1,Tyler Seibring,FR,F,Elon,CAA,32,899,116,250,57,100,59,150,21,32,41,112,153,62,15,17,28,78,312
Elon2,2,Tanner Samson,SR,G,Elon,CAA,32,895,109,267,27,44,82,223,78,100,19,117,136,70,32,15,33,83,378
Elon3,3,Luke Eddy,JR,G,Elon,CAA,32,849,114,287,89,191,25,96,84,123,20,72,92,144,33,1,93,50,337
Elon4,4,Dmitri Thompson,SO,G,Elon,CAA,32,800,125,252,111,201,14,51,52,81,42,110,152,38,26,3,57,60,316
Elon5,5,Dainan Swoope,FR,G,Elon,CAA,32,715,94,248,34,85,60,163,42,62,19,61,80,60,20,1,38,48,290
Elon6,6,Christian Hairston,JR,G,Elon,CAA,32,689,116,191,116,191,0,0,43,79,52,135,187,36,19,15,41,82,275
Elon7,7,Steve Santa Ana,FR,G,Elon,CAA,27,499,77,189,35,73,42,116,35,53,28,63,91,36,6,4,33,38,231
Elon8,8,Brian Dawkins,SO,F,Elon,CAA,25,367,60,117,54,88,6,29,15,29,14,52,66,12,10,7,31,55,141
Elon9,9,Jack Anton,SO,F,Elon,CAA,31,272,21,52,17,35,4,17,9,15,21,27,48,13,3,5,15,49,55
Elon10,10,Karolis Kundrotas,FR,F,Elon,CAA,28,153,11,38,5,20,6,18,5,9,11,17,28,1,4,4,14,28,33
Elon11,11,Collin Luther,SO,G,Elon,CAA,22,131,4,13,4,9,0,4,3,5,7,16,23,7,4,0,6,21,11
Elon12,12,Sheldon Eberhardt,FR,G,Elon,CAA,16,98,9,24,4,8,5,16,2,2,5,8,13,4,4,0,7,10,25
Elon13,13,Sam Hershberger,SR,G,Elon,CAA,9,15,2,5,2,3,0,2,6,6,0,1,1,1,0,0,0,3,10
Elon14,14,Tony Sabato,SR,C,Elon,CAA,6,15,1,2,1,2,0,0,1,3,0,3,3,1,0,0,1,1,3
Elon15,15,Wes Brewer,JR,F,Elon,CAA,6,10,3,3,3,3,0,0,0,0,0,2,2,1,0,0,2,0,6
Elon16,16,Patrick Ryan,JR,G,Elon,CAA,3,6,3,3,3,3,0,0,0,0,0,0,0,0,0,0,2,0,6
Evansville1,1,D.J. Balentine,SR,G,Evansville,MVC,34,1253,240,543,182,372,58,171,160,204,26,87,113,148,24,9,92,58,698
Evansville2,2,Egidijus Mockevicius,SR,C,Evansville,MVC,34,1082,195,306,195,306,0,0,145,212,85,389,474,9,27,94,55,110,535
Evansville3,3,Jaylon Brown,JR,G,Evansville,MVC,34,1024,129,254,113,202,16,52,92,127,13,71,84,99,37,4,65,82,366
Evansville4,4,Adam Wing,SR,G,Evansville,MVC,34,1001,94,183,73,143,21,40,55,66,25,99,124,90,24,10,47,77,264
Evansville5,5,Blake Simmons,JR,G,Evansville,MVC,34,951,71,168,42,78,29,90,29,37,5,62,67,100,19,9,45,63,200
Evansville6,6,Mislav Brzoja,JR,G,Evansville,MVC,34,818,83,190,54,115,29,75,70,94,32,88,120,106,30,5,62,79,265
Evansville7,7,Harris Brown,FR,G,Evansville,MVC,24,187,8,35,3,17,5,18,13,19,2,8,10,17,3,0,12,27,34
Evansville8,8,Christian Benzon,JR,G,Evansville,MVC,24,160,17,33,17,32,0,1,10,20,6,24,30,10,4,2,6,29,44
Evansville9,9,David Howard,JR,F,Evansville,MVC,28,150,17,33,17,32,0,1,22,39,14,25,39,4,3,6,13,39,56
Evansville10,10,Willie Wiley,JR,F,Evansville,MVC,18,127,16,35,16,35,0,0,12,20,14,22,36,2,5,4,11,19,44
Evansville11,11,Duane Gibson,JR,G,Evansville,MVC,4,57,4,7,4,7,0,0,0,1,0,7,7,8,2,1,5,12,8
Evansville12,12,Sergej Vucetic,JR,C,Evansville,MVC,11,40,5,8,5,8,0,0,2,4,1,2,3,2,0,3,4,6,12
Fairfield1,1,Tyler Nelson,SO,G,Fairfield,MAAC,32,1134,152,354,88,172,64,182,141,159,16,83,99,92,42,0,52,39,509
Fairfield2,2,Marcus Gilbert,SR,F,Fairfield,MAAC,30,987,162,376,84,172,78,204,108,138,24,135,159,44,28,19,64,70,510
Fairfield3,3,Jerome Segura,SO,G,Fairfield,MAAC,31,924,92,216,80,181,12,35,25,48,26,68,94,159,30,0,89,56,221
Fairfield4,4,Curtis Cobb,FR,G,Fairfield,MAAC,29,740,116,264,72,143,44,121,36,53,19,78,97,52,39,11,47,62,312
Fairfield5,5,Jonathan Kasibabu,FR,F,Fairfield,MAAC,32,611,71,137,66,123,5,14,44,67,67,107,174,31,14,37,53,112,191
Fairfield6,6,Matija Milin,FR,F,Fairfield,MAAC,30,603,93,184,74,119,19,65,48,69,33,77,110,32,8,11,32,71,253
Fairfield7,7,Jerry Johnson Jr.,FR,G,Fairfield,MAAC,28,505,70,159,29,60,41,99,35,52,12,59,71,39,22,2,40,37,216
Fairfield8,8,Coleman Johnson,SR,F,Fairfield,MAAC,28,424,25,63,25,62,0,1,12,18,35,70,105,20,9,37,14,73,62
Fairfield9,9,Scott King,SR,F,Fairfield,MAAC,23,257,32,72,26,48,6,24,3,5,3,41,44,16,4,8,12,53,73
Fairfield10,10,Kevin Degnan,SO,F,Fairfield,MAAC,23,171,30,61,17,32,13,29,1,6,6,30,36,6,3,5,5,21,74
Fairfield11,11,Steve Smith,JR,F,Fairfield,MAAC,13,92,6,21,0,0,6,21,0,0,1,10,11,3,3,1,3,9,18
Fairfield12,12,Mike Kirkland,SR,F,Fairfield,MAAC,11,62,5,18,4,15,1,3,7,10,2,7,9,3,3,1,5,9,18
Fairleigh Dickinson1,1,Darian Anderson,SO,G,Fairleigh Dickinson,NEC,32,1059,178,432,132,295,46,137,90,111,23,89,112,118,58,8,100,80,492
Fairleigh Dickinson2,2,Earl Potts,SO,G,Fairleigh Dickinson,NEC,32,1020,175,343,113,187,62,156,57,79,46,155,201,47,36,10,46,110,469
Fairleigh Dickinson3,3,Marques Townes,SO,G,Fairleigh Dickinson,NEC,32,984,138,288,103,187,35,101,54,79,31,98,129,85,42,3,58,52,365
Fairleigh Dickinson4,4,Stephan Jiggetts,SO,G,Fairleigh Dickinson,NEC,31,973,101,271,66,174,35,97,110,150,16,55,71,96,35,0,78,89,347
Fairleigh Dickinson5,5,Mike Holloway,FR,F,Fairleigh Dickinson,NEC,31,739,117,196,117,196,0,0,64,100,85,91,176,22,19,33,32,110,298
Fairleigh Dickinson6,6,Darnell Edge,FR,G,Fairleigh Dickinson,NEC,32,422,50,113,32,69,18,44,19,20,18,21,39,27,11,0,14,32,137
Fairleigh Dickinson7,7,Tyrone O'Garro,JR,F,Fairleigh Dickinson,NEC,26,363,39,69,39,69,0,0,11,27,33,48,81,18,14,10,24,69,89
Fairleigh Dickinson8,8,Ghassan Nehme,FR,G,Fairleigh Dickinson,NEC,32,352,46,111,16,41,30,70,13,16,5,47,52,19,13,2,23,59,135
Fairleigh Dickinson9,9,Malik Miller,FR,C,Fairleigh Dickinson,NEC,29,265,40,74,37,57,3,17,22,42,22,43,65,4,5,15,11,47,105
Fairleigh Dickinson10,10,DaRon Curry,FR,G,Fairleigh Dickinson,NEC,22,118,11,25,11,24,0,1,8,12,1,8,9,14,3,0,9,20,30
Fairleigh Dickinson11,11,Dondre Rhoden,FR,F,Fairleigh Dickinson,NEC,26,109,7,16,7,15,0,1,1,4,5,11,16,1,3,5,4,20,15
Fairleigh Dickinson12,12,Mike Schroback,SO,G,Fairleigh Dickinson,NEC,19,63,3,15,2,5,1,10,2,5,0,3,3,5,2,0,7,5,9
Fairleigh Dickinson13,13,Myles Mann,JR,F,Fairleigh Dickinson,NEC,2,8,1,6,1,6,0,0,0,0,0,1,1,0,0,0,0,1,2
Florida1,1,Dorian Finney-Smith,SR,F,Florida,SEC,33,1048,157,352,92,178,65,174,111,150,82,190,272,70,27,27,62,69,490
Florida2,2,KeVaughn Allen,FR,G,Florida,SEC,33,888,119,301,75,158,44,143,94,111,17,72,89,53,37,5,33,54,376
Florida3,3,John Egbunu,SO,C,Florida,SEC,33,833,143,242,143,242,0,0,91,170,90,120,210,11,15,47,60,110,377
Florida4,4,Chris Chiozza,SO,G,Florida,SEC,33,798,79,237,42,116,37,121,41,52,10,89,99,141,34,2,61,74,236
Florida5,5,Devin Robinson,SO,F,Florida,SEC,33,767,108,232,73,134,35,98,56,74,60,129,189,13,18,20,26,74,307
Florida6,6,Kasey Hill,JR,G,Florida,SEC,33,764,100,259,85,204,15,55,70,127,11,67,78,105,44,11,63,81,285
Florida7,7,Justin Leon,JR,F,Florida,SEC,31,443,60,123,41,66,19,57,10,24,38,52,90,8,9,4,19,45,149
Florida8,8,Kevarrius Hayes,FR,F,Florida,SEC,32,328,22,36,22,36,0,0,22,53,37,44,81,5,10,18,17,59,66
Florida9,9,Brandone Francis,FR,G,Florida,SEC,28,311,21,103,11,45,10,58,7,13,7,22,29,15,10,0,10,24,59
Florida10,10,DeVon Walker,JR,G,Florida,SEC,24,259,13,56,11,37,2,19,12,25,18,21,39,6,5,6,9,25,40
Florida11,11,Schuyler Rimmer,JR,F,Florida,SEC,22,139,11,28,10,27,1,1,8,8,10,19,29,3,0,5,6,23,31
Florida12,12,Alex Murphy,SR,F,Florida,SEC,3,23,4,10,3,6,1,4,1,4,2,2,4,0,0,1,1,5,10
Florida13,13,Zach Hodskins,SO,G,Florida,SEC,7,8,1,5,1,3,0,2,0,1,0,1,1,0,0,0,0,2,2
Florida A&M1,1,Malcolm Bernard,SR,F,Florida A&M,MEAC,28,912,126,299,114,242,12,57,138,209,39,158,197,119,63,19,98,83,402
Florida A&M2,2,Justin Ravenel,FR,G,Florida A&M,MEAC,29,820,81,234,20,61,61,173,29,42,15,63,78,15,12,0,28,48,252
Florida A&M3,3,Craig Bowman,SO,G,Florida A&M,MEAC,29,767,85,255,53,146,32,109,76,114,15,71,86,53,38,2,66,66,278
Florida A&M4,4,K'ja Johnson,FR,G,Florida A&M,MEAC,24,675,60,159,41,94,19,65,42,77,9,53,62,60,27,6,58,45,181
Florida A&M5,5,Francois Lewis,FR,F,Florida A&M,MEAC,29,643,76,171,53,94,23,77,22,52,28,75,103,11,16,8,31,82,197
Florida A&M6,6,Trey Warren,JR,F,Florida A&M,MEAC,28,441,59,122,58,120,1,2,36,61,45,70,115,1,4,5,49,70,155
Florida A&M7,7,Jerran Foster,SR,G,Florida A&M,MEAC,28,420,29,85,10,26,19,59,6,13,2,27,29,35,8,2,26,25,83
Florida A&M8,8,Mario Karailiev,JR,C,Florida A&M,MEAC,26,345,26,54,26,53,0,1,7,14,12,32,44,5,6,3,22,41,59
Florida A&M9,9,Nick Severado,FR,G,Florida A&M,MEAC,19,325,18,58,17,54,1,4,15,30,23,31,54,10,9,8,20,23,52
Florida A&M10,10,Isaiah Omoregie,FR,F,Florida A&M,MEAC,19,296,61,101,61,100,0,1,23,56,24,40,64,2,6,6,26,44,145
Florida A&M11,11,Jordan Jackson,SO,F,Florida A&M,MEAC,13,157,13,33,13,33,0,0,7,13,12,33,45,4,2,4,12,27,33
Florida A&M12,12,Johnathan Spicer,SO,F,Florida A&M,MEAC,20,133,10,28,10,25,0,3,5,8,10,13,23,4,0,2,14,8,25
Florida Atlantic1,1,Jackson Trapp,SR,G,Florida Atlantic,CUSA,33,926,83,209,32,73,51,136,30,39,7,83,90,32,14,12,26,51,247
Florida Atlantic2,2,Adonis Filer,JR,G,Florida Atlantic,CUSA,32,901,107,269,81,179,26,90,91,120,26,127,153,67,31,2,66,80,331
Florida Atlantic3,3,Jeantal Cylla,FR,F,Florida Atlantic,CUSA,33,870,105,272,61,144,44,128,65,89,25,89,114,16,18,15,44,85,319
Florida Atlantic4,4,Nick Rutherford,FR,G,Florida Atlantic,CUSA,33,866,74,202,63,164,11,38,80,114,17,79,96,117,49,9,90,72,239
Florida Atlantic5,5,Marquan Botley,JR,G,Florida Atlantic,CUSA,31,648,82,227,33,102,49,125,62,73,11,44,55,76,21,0,35,34,275
Florida Atlantic6,6,Ronald Delph,SO,C,Florida Atlantic,CUSA,25,644,108,199,108,199,0,0,47,69,71,100,171,10,6,61,36,90,263
Florida Atlantic7,7,Jesse Hill,FR,F,Florida Atlantic,CUSA,30,549,50,136,32,82,18,54,25,41,17,63,80,11,7,21,9,59,143
Florida Atlantic8,8,Solomon Poole,SR,G,Florida Atlantic,CUSA,28,538,73,195,50,104,23,91,19,31,12,48,60,41,20,2,50,51,188
Florida Atlantic9,9,C.J. Turman,SO,C,Florida Atlantic,CUSA,11,316,39,76,39,75,0,1,31,42,18,59,77,10,6,11,25,33,109
Florida Atlantic10,10,Matthew Reed,JR,F,Florida Atlantic,CUSA,13,161,17,30,17,30,0,0,5,5,9,28,37,0,1,6,4,33,39
Florida Atlantic11,11,Javier Lacunza,SR,F,Florida Atlantic,CUSA,19,139,10,25,3,10,7,15,1,1,10,15,25,1,1,0,7,29,28
Florida Atlantic12,12,Connor Shorten,FR,F,Florida Atlantic,CUSA,11,67,4,7,4,7,0,0,0,0,3,10,13,4,1,1,1,14,8
Florida Gulf Coast1,1,Marc Eddy Norelia,JR,F,Florida Gulf Coast,A-Sun,33,1084,219,406,219,404,0,2,129,189,101,203,304,39,38,28,58,67,567
Florida Gulf Coast2,2,Christian Terrell,SO,G,Florida Gulf Coast,A-Sun,33,958,152,337,107,214,45,123,68,97,35,126,161,72,40,13,41,66,417
Florida Gulf Coast3,3,Zach Johnson,FR,G,Florida Gulf Coast,A-Sun,33,880,135,282,110,218,25,64,75,112,11,72,83,106,28,15,72,79,370
Florida Gulf Coast4,4,Julian DeBose,SR,G,Florida Gulf Coast,A-Sun,31,851,106,250,77,164,29,86,26,42,28,67,95,37,33,16,42,64,267
Florida Gulf Coast5,5,Rayjon Tucker,FR,G,Florida Gulf Coast,A-Sun,33,636,63,118,50,80,13,38,69,97,24,80,104,25,21,8,40,59,208
Florida Gulf Coast6,6,Reggie Reid,FR,G,Florida Gulf Coast,A-Sun,32,546,41,113,25,61,16,52,23,38,4,38,42,103,22,3,39,60,121
Florida Gulf Coast7,7,Antravious Simmons,SO,F,Florida Gulf Coast,A-Sun,32,535,104,195,104,194,0,1,38,63,54,105,159,22,13,12,34,95,246
Florida Gulf Coast8,8,Filip Cvjeticanin,SR,F,Florida Gulf Coast,A-Sun,30,449,46,127,4,13,42,114,3,9,7,46,53,12,6,2,11,24,137
Florida Gulf Coast9,9,Demetris Morant,JR,F,Florida Gulf Coast,A-Sun,21,388,48,84,48,84,0,0,24,50,38,76,114,6,3,30,25,68,120
Florida Gulf Coast10,10,Kevin Mickle,SO,F,Florida Gulf Coast,A-Sun,29,303,25,52,25,52,0,0,8,17,25,35,60,8,6,4,28,38,58
Florida Gulf Coast11,11,Brian Greene,JR,G,Florida Gulf Coast,A-Sun,16,103,6,17,2,9,4,8,3,5,0,9,9,14,5,1,6,16,19
Florida Gulf Coast12,12,Maxx Bleecher,FR,G,Florida Gulf Coast,A-Sun,10,18,2,5,1,2,1,3,0,0,1,1,2,1,1,0,2,1,5
Florida Gulf Coast13,13,Dolan Mahoney,FR,G,Florida Gulf Coast,A-Sun,8,17,2,4,1,2,1,2,0,0,0,1,1,1,2,0,0,0,5
Florida International1,1,Daviyon Draper,SR,F,Florida International,CUSA,31,1089,195,430,162,346,33,84,69,98,44,173,217,68,31,20,85,76,492
Florida International2,2,Donte McGill,JR,G,Florida International,CUSA,31,1006,189,391,154,308,35,83,86,108,47,96,143,39,24,3,66,48,499
Florida International3,3,Adrian Diaz,SR,C,Florida International,CUSA,32,953,180,277,180,277,0,0,128,206,102,149,251,28,20,93,68,113,488
Florida International4,4,Jason Boswell,JR,G,Florida International,CUSA,32,831,57,140,34,76,23,64,24,35,11,59,70,54,14,7,34,94,161
Florida International5,5,Eric Nottage,SO,G,Florida International,CUSA,32,661,41,106,15,39,26,67,31,42,16,87,103,81,22,1,53,68,139
Florida International6,6,Kimar Williams,FR,G,Florida International,CUSA,32,632,41,114,38,97,3,17,37,63,16,79,95,79,28,2,36,56,122
Florida International7,7,Elmo Stephen,JR,F,Florida International,CUSA,23,448,57,146,19,45,38,101,24,38,19,49,68,8,7,4,16,42,176
Florida International8,8,Cameron Smith,SO,F,Florida International,CUSA,28,358,34,60,34,60,0,0,17,28,20,64,84,6,6,15,15,57,85
Florida International9,9,Ray Rodriguez,JR,G,Florida International,CUSA,20,295,24,67,6,13,18,54,7,10,2,25,27,24,8,0,22,22,73
Florida International10,10,Michael Douglas,FR,F,Florida International,CUSA,26,195,12,41,7,12,5,29,4,15,6,24,30,3,2,3,3,17,33
Florida International11,11,Hassan Hussein,SO,F,Florida International,CUSA,2,26,4,6,4,6,0,0,1,2,1,4,5,1,0,0,1,3,9
Florida State1,1,Malik Beasley,FR,G,Florida State,ACC,32,954,172,368,121,233,51,135,99,123,40,126,166,48,30,3,54,70,494
Florida State2,2,Dwayne Bacon,FR,G,Florida State,ACC,32,917,185,415,153,305,32,110,97,137,43,143,186,44,30,1,70,67,499
Florida State3,3,Xavier Rathan-Mayes,SO,G,Florida State,ACC,31,905,121,298,84,170,37,128,83,107,12,76,88,139,33,0,78,68,362
Florida State4,4,Devon Bookert,SR,G,Florida State,ACC,31,808,105,238,46,93,59,145,35,48,28,53,81,85,51,2,42,60,304
Florida State5,5,Montay Brandon,SR,G,Florida State,ACC,31,621,35,81,33,74,2,7,30,55,38,60,98,31,18,8,31,64,102
Florida State6,6,Boris Bojanovsky,SR,C,Florida State,ACC,32,586,72,124,72,120,0,4,58,83,61,82,143,14,20,58,39,90,202
Florida State7,7,Terance Mann,FR,G,Florida State,ACC,32,532,66,112,62,99,4,13,25,55,41,72,113,27,19,6,24,56,161
Florida State8,8,Jarquez Smith,JR,F,Florida State,ACC,32,454,67,122,65,110,2,12,23,34,39,73,112,6,14,32,35,74,159
Florida State9,9,Benji Bell,JR,G,Florida State,ACC,31,327,39,96,16,44,23,52,24,43,7,26,33,28,10,0,22,28,125
Florida State10,10,Chris Koumadje,FR,C,Florida State,ACC,26,159,13,27,13,27,0,0,7,17,10,28,38,1,0,19,11,36,33
Florida State11,11,Phil Cofer,SO,F,Florida State,ACC,11,132,13,23,13,22,0,1,16,19,5,17,22,2,4,3,7,9,42
Florida State12,12,Michael Saxton,SR,G,Florida State,ACC,11,30,6,15,2,5,4,10,0,0,4,6,10,0,1,0,1,1,16
Fordham1,1,Ryan Rhoomes,SR,F,Fordham,A-10,30,946,182,280,182,280,0,0,77,131,124,162,286,40,21,52,58,99,441
Fordham2,2,Christian Sengfelder,SO,F,Fordham,A-10,29,876,98,236,52,115,46,121,47,59,53,99,152,28,21,8,43,77,289
Fordham3,3,Joseph Chartouny,FR,G,Fordham,A-10,25,818,80,218,48,115,32,103,91,118,14,124,138,152,52,4,70,60,283
Fordham4,4,Mandell Thomas,SR,G,Fordham,A-10,25,700,111,264,62,141,49,123,38,59,10,82,92,48,54,5,37,48,309
Fordham5,5,Antwoine Anderson,SO,G,Fordham,A-10,27,649,75,165,58,112,17,53,62,90,11,49,60,70,32,9,63,74,229
Fordham6,6,Nemanja Zarkovic,SO,G,Fordham,A-10,30,539,31,96,11,30,20,66,8,12,13,34,47,40,13,1,17,68,90
Fordham7,7,David Pekarek,FR,F,Fordham,A-10,29,532,52,151,23,52,29,99,17,25,11,48,59,18,8,11,35,48,150
Fordham8,8,Jon Severe,JR,G,Fordham,A-10,29,514,80,182,50,101,30,81,34,46,15,33,48,47,28,9,46,58,224
Fordham9,9,Nych Smith,FR,G,Fordham,A-10,19,194,21,49,13,23,8,26,9,12,0,13,13,18,8,2,8,12,59
Fordham10,10,Jesse Bunting,FR,F,Fordham,A-10,23,161,17,28,17,28,0,0,6,11,7,16,23,4,6,5,10,22,40
Fordham11,11,Ryan Canty,SR,C,Fordham,A-10,21,125,8,17,8,17,0,0,5,13,11,30,41,2,7,10,8,25,21
Fordham12,12,Chris Downing,FR,F,Fordham,A-10,2,4,1,1,1,1,0,0,0,0,1,0,1,0,1,0,0,1,2
Fordham13,13,Thomas Sanchez,SO,G,Fordham,A-10,2,4,1,2,0,1,1,1,0,0,0,0,0,0,0,0,0,0,3
Fresno State1,1,Marvelle Harris,SR,G,Fresno State,MWC,34,1246,232,573,169,377,63,196,174,233,18,141,159,150,74,21,74,100,701
Fresno State2,2,Cezar Guerrero,SR,G,Fresno State,MWC,34,865,90,230,41,98,49,132,52,68,19,88,107,82,29,0,43,92,281
Fresno State3,3,Cullen Russo,JR,F,Fresno State,MWC,33,846,91,217,79,161,12,56,69,105,55,148,203,58,54,20,38,103,263
Fresno State4,4,Julien Lewis,SR,G,Fresno State,MWC,33,756,108,253,81,190,27,63,40,57,14,72,86,56,41,5,40,86,283
Fresno State5,5,Karachi Edo,JR,F,Fresno State,MWC,31,752,118,216,118,215,0,1,72,123,102,97,199,13,10,49,29,77,308
Fresno State6,6,Paul Watson,JR,G,Fresno State,MWC,30,725,81,203,52,123,29,80,38,53,24,72,96,21,20,16,33,65,229
Fresno State7,7,Torren Jones,JR,F,Fresno State,MWC,21,553,90,173,90,173,0,0,41,62,71,94,165,14,16,12,39,58,221
Fresno State8,8,Lionel Ellison III,JR,G,Fresno State,MWC,30,430,10,45,7,27,3,18,28,42,9,40,49,34,17,2,18,48,51
Fresno State9,9,Terrell Carter,SO,C,Fresno State,MWC,28,293,45,75,45,75,0,0,22,31,29,40,69,6,6,8,29,66,112
Fresno State10,10,Jahmel Taylor,JR,G,Fresno State,MWC,18,244,27,64,3,7,24,57,11,14,9,19,28,17,9,1,5,25,89
Fresno State11,11,Sam Bittner,FR,G,Fresno State,MWC,17,165,6,16,1,2,5,14,2,5,2,15,17,5,3,1,1,19,19
Fresno State12,12,Grant Shell,FR,G,Fresno State,MWC,6,13,1,5,1,2,0,3,0,0,2,0,2,1,1,0,4,1,2
Fresno State13,13,Ountae Campbell,FR,G,Fresno State,MWC,7,12,1,3,1,3,0,0,0,0,0,3,3,1,0,0,0,1,2
Furman1,1,Stephen Croone,SR,G,Furman,Southern,31,932,150,344,108,189,42,155,184,239,10,99,109,77,37,10,76,74,526
Furman2,2,Devin Sibley,SO,G,Furman,Southern,33,892,134,298,94,177,40,121,86,124,21,71,92,56,18,6,76,79,394
Furman3,3,Matt Rafferty,FR,F,Furman,Southern,33,782,92,191,76,140,16,51,66,83,76,148,224,61,35,28,39,68,266
Furman4,4,Kris Acox,JR,F,Furman,Southern,33,751,129,207,129,206,0,1,42,84,78,112,190,18,19,18,42,73,300
Furman5,5,Daniel Fowler,SO,G,Furman,Southern,30,738,59,144,29,66,30,78,33,51,37,81,118,50,28,6,49,75,181
Furman6,6,John Davis,SO,G,Furman,Southern,31,684,45,133,21,64,24,69,36,43,6,46,52,57,24,0,31,50,150
Furman7,7,Geoff Beans,SO,F,Furman,Southern,33,545,54,133,10,15,44,118,30,41,15,52,67,23,9,6,27,70,182
Furman8,8,Larry Wideman,SR,G,Furman,Southern,32,436,32,84,17,27,15,57,10,18,17,59,76,22,12,7,20,31,89
Furman9,9,Kendrec Ferrara,SR,F,Furman,Southern,33,426,63,110,54,82,9,28,17,36,32,49,81,10,7,23,30,49,152
Furman10,10,Andrew Brown,FR,G,Furman,Southern,21,231,24,59,9,19,15,40,9,13,10,33,43,12,7,2,9,10,72
Furman11,11,Jonathan Jean,FR,G,Furman,Southern,21,150,13,37,11,26,2,11,6,6,0,13,13,18,3,0,18,13,34
Furman12,12,T.K. Hayes,JR,G,Furman,Southern,8,17,1,5,1,2,0,3,0,0,0,2,2,0,1,0,1,0,2
Furman13,13,Gene Langan,SO,F,Furman,Southern,8,16,3,6,3,5,0,1,3,4,3,3,6,0,0,0,1,2,9
Gardner-Webb1,1,Harold McBride,SR,G,Gardner-Webb,Big South,33,954,135,360,73,191,62,169,90,108,20,76,96,133,47,3,72,57,422
Gardner-Webb2,2,Tyrell Nelson,JR,C,Gardner-Webb,Big South,33,898,181,324,176,307,5,17,100,163,102,150,252,53,21,26,86,87,467
Gardner-Webb3,3,Dylan Poston,SR,G,Gardner-Webb,Big South,33,819,103,291,38,93,65,198,39,56,11,79,90,34,34,6,30,47,310
Gardner-Webb4,4,Isaiah Ivey,SR,G,Gardner-Webb,Big South,33,783,95,236,51,129,44,107,61,71,39,92,131,36,20,9,34,53,295
Gardner-Webb5,5,Adonis Burbage,SR,G,Gardner-Webb,Big South,30,764,100,260,36,89,64,171,25,40,28,77,105,26,23,1,37,43,289
Gardner-Webb6,6,L'Hassane Niangane,FR,C,Gardner-Webb,Big South,33,557,31,66,31,66,0,0,30,51,71,80,151,12,11,37,35,103,92
Gardner-Webb7,7,Laquincy Rideau,FR,G,Gardner-Webb,Big South,33,523,69,158,54,108,15,50,37,81,16,58,74,84,67,2,55,92,190
Gardner-Webb8,8,Brandon Miller,FR,F,Gardner-Webb,Big South,33,452,42,76,42,76,0,0,30,55,39,55,94,8,8,16,23,95,114
Gardner-Webb9,9,David Efianayi,FR,G,Gardner-Webb,Big South,20,347,60,123,52,93,8,30,19,32,7,30,37,32,13,6,26,16,147
Gardner-Webb10,10,Jamaal Robateau,SO,G,Gardner-Webb,Big South,25,274,27,84,16,30,11,54,15,22,11,42,53,17,12,1,18,15,80
Gardner-Webb11,11,Herve Aholode,SR,F,Gardner-Webb,Big South,24,199,13,28,13,27,0,1,7,12,17,23,40,5,6,4,5,35,33
Gardner-Webb12,12,DJ Laster,FR,F,Gardner-Webb,Big South,15,105,15,33,13,23,2,10,5,10,11,6,17,2,3,2,10,23,37
George Mason1,1,Otis Livingston II,FR,G,George Mason,A-10,32,1097,124,318,78,188,46,130,87,114,10,72,82,114,23,0,69,56,381
George Mason2,2,Jaire Grayer,FR,G,George Mason,A-10,32,945,115,303,72,158,43,145,30,54,32,88,120,27,11,12,46,89,303
George Mason3,3,Marquise Moore,JR,G,George Mason,A-10,28,910,111,279,110,263,1,16,95,140,26,144,170,86,18,26,58,64,318
George Mason4,4,Marko Gujanicic,SR,F,George Mason,A-10,28,724,94,222,66,137,28,85,42,59,56,125,181,41,5,2,37,69,258
George Mason5,5,Shevon Thompson,SR,C,George Mason,A-10,31,699,120,208,120,207,0,1,67,120,113,216,329,17,4,31,81,74,307
George Mason6,6,Jalen Jenkins,JR,F,George Mason,A-10,32,686,87,175,87,175,0,0,54,78,77,100,177,18,15,25,49,106,228
George Mason7,7,DeAndre Abram,FR,G,George Mason,A-10,32,658,76,221,43,101,33,120,26,37,25,69,94,6,6,12,21,46,211
George Mason8,8,Kameron Murrell,FR,G,George Mason,A-10,32,372,17,91,2,24,15,67,13,16,10,30,40,9,5,3,16,26,62
George Mason9,9,Danny Dixon,FR,F,George Mason,A-10,25,187,9,23,9,23,0,0,13,20,12,19,31,7,0,5,9,26,31
George Mason10,10,Myles Tate,JR,G,George Mason,A-10,15,67,2,10,1,6,1,4,5,6,0,6,6,3,3,0,4,6,10
George Mason11,11,Patrick Holloway,SR,G,George Mason,A-10,4,55,7,23,2,7,5,16,2,3,0,5,5,0,1,1,2,2,21
George Mason12,12,Julian Royal,SR,F,George Mason,A-10,7,32,4,13,4,8,0,5,2,3,3,2,5,0,1,2,5,4,10
George Washington1,1,Kevin Larsen,SR,F,George Washington,A-10,33,1113,138,280,127,258,11,22,100,138,100,178,278,82,30,25,61,71,387
George Washington2,2,Patricio Garino,SR,G,George Washington,A-10,33,1056,171,342,121,229,50,113,68,98,45,94,139,51,46,29,64,82,460
George Washington3,3,Tyler Cavanaugh,JR,F,George Washington,A-10,33,993,178,351,136,246,42,105,143,172,58,186,244,41,18,8,71,81,541
George Washington4,4,Joe McDonald,SR,G,George Washington,A-10,31,922,83,212,67,155,16,57,80,113,46,121,167,94,34,5,45,66,262
George Washington5,5,Yuta Watanabe,SO,F,George Washington,A-10,33,891,95,222,66,126,29,96,62,88,29,93,122,47,18,32,39,65,281
George Washington6,6,Paul Jorgensen,SO,G,George Washington,A-10,33,553,60,165,38,106,22,59,38,51,17,53,70,76,17,2,39,34,180
George Washington7,7,Alex Mitola,SR,G,George Washington,A-10,33,502,50,144,18,50,32,94,44,50,13,36,49,52,18,0,21,47,176
George Washington8,8,Matt Hart,JR,G,George Washington,A-10,33,302,46,105,24,51,22,54,21,24,3,24,27,10,10,0,12,40,135
George Washington9,9,Jordan Roland,FR,G,George Washington,A-10,31,153,10,43,9,30,1,13,15,20,5,9,14,5,5,1,5,21,36
George Washington10,10,Anthony Swan,SO,G,George Washington,A-10,33,114,10,26,6,18,4,8,0,0,9,13,22,4,1,6,7,26,24
Georgetown1,1,D'Vauntes Smith-Rivera,SR,G,Georgetown,Big East,33,1168,172,416,99,195,73,221,116,143,22,98,120,150,48,10,69,78,533
Georgetown2,2,Isaac Copeland,SO,F,Georgetown,Big East,33,1048,130,303,96,178,34,125,71,92,47,131,178,66,25,20,54,68,365
Georgetown3,3,L.J. Peak,SO,G,Georgetown,Big East,33,824,136,277,98,184,38,93,95,125,23,85,108,56,25,21,57,116,405
Georgetown4,4,Marcus Derrickson,FR,F,Georgetown,Big East,32,692,68,167,30,66,38,101,53,61,47,97,144,36,14,19,51,100,227
Georgetown5,5,Tre Campbell,SO,G,Georgetown,Big East,30,627,40,131,20,57,20,74,24,31,13,41,54,50,22,2,26,43,124
Georgetown6,6,Bradley Hayes,SR,C,Georgetown,Big East,27,592,98,181,98,181,0,0,40,67,48,133,181,32,9,28,43,86,236
Georgetown7,7,Jessie Govan,FR,C,Georgetown,Big East,33,583,71,148,57,120,14,28,69,83,28,108,136,26,13,33,58,102,225
Georgetown8,8,Reggie Cameron,JR,F,Georgetown,Big East,32,555,57,142,21,41,36,101,28,36,14,51,65,39,5,3,27,46,178
Georgetown9,9,Kaleb Johnson,FR,G,Georgetown,Big East,32,350,29,50,22,37,7,13,26,50,17,38,55,16,11,4,20,63,91
Georgetown10,10,Trey Mourning,SO,F,Georgetown,Big East,20,124,12,23,11,17,1,6,4,7,7,13,20,6,4,5,9,29,29
Georgetown11,11,Paul White,SO,F,Georgetown,Big East,7,67,5,13,5,8,0,5,1,2,1,10,11,11,1,1,5,6,11
Georgetown12,12,Riyan Williams,SR,G,Georgetown,Big East,23,45,2,7,2,4,0,3,2,7,1,4,5,4,3,0,4,18,6
Georgia1,1,J.J. Frazier,JR,G,Georgia,SEC,32,1026,161,388,87,200,74,188,148,182,16,132,148,136,47,3,52,85,544
Georgia2,2,Yante Maten,SO,F,Georgia,SEC,32,953,192,388,187,377,5,11,128,163,85,170,255,24,9,60,74,88,517
Georgia3,3,Kenny Gaines,SR,G,Georgia,SEC,32,927,134,349,51,137,83,212,60,82,25,73,98,33,25,22,50,102,411
Georgia4,4,Charles Mann,SR,G,Georgia,SEC,32,916,85,221,68,174,17,47,146,210,17,116,133,87,28,1,92,92,333
Georgia5,5,Kenny Paul Geno,JR,F,Georgia,SEC,32,633,32,91,20,44,12,47,8,14,25,70,95,47,18,13,19,56,84
Georgia6,6,Mike Edwards,FR,F,Georgia,SEC,32,526,37,83,37,83,0,0,11,37,38,66,104,11,4,16,28,77,85
Georgia7,7,Houston Kessler,JR,F,Georgia,SEC,32,513,29,77,27,59,2,18,9,15,36,56,92,9,10,13,24,68,69
Georgia8,8,Derek Ogbeide,FR,F,Georgia,SEC,27,408,46,99,46,99,0,0,17,36,48,89,137,12,3,21,33,47,109
Georgia9,9,E'Torrion Wilridge,FR,F,Georgia,SEC,31,281,14,25,11,16,3,9,8,18,6,36,42,19,2,11,17,17,39
Georgia10,10,William Jackson II,FR,G,Georgia,SEC,29,203,12,42,3,14,9,28,9,12,6,9,15,17,10,6,17,21,42
Georgia11,11,Osahen Iduwe,SO,F,Georgia,SEC,17,53,2,5,2,5,0,0,5,10,3,5,8,0,0,1,2,15,9
Georgia Southern1,1,Tookie Brown,FR,G,Georgia Southern,Sun Belt,31,956,177,408,127,274,50,134,147,181,18,82,100,104,51,4,69,81,551
Georgia Southern2,2,Mike Hughes,SO,G,Georgia Southern,Sun Belt,30,907,141,326,74,152,67,174,99,136,26,116,142,48,63,10,62,77,448
Georgia Southern3,3,Jake Allsmiller,SO,G,Georgia Southern,Sun Belt,31,833,74,221,9,24,65,197,28,30,9,45,54,38,20,7,26,73,241
Georgia Southern4,4,Ike Smith,FR,G,Georgia Southern,Sun Belt,30,764,115,306,69,167,46,139,74,106,37,107,144,34,26,11,53,61,350
Georgia Southern5,5,Devonte Boykins,SO,G,Georgia Southern,Sun Belt,31,729,56,157,39,92,17,65,53,75,13,56,69,56,18,3,33,55,182
Georgia Southern6,6,Coye Simmons,SO,F,Georgia Southern,Sun Belt,31,471,43,98,43,98,0,0,24,47,65,105,170,3,4,7,21,69,110
Georgia Southern7,7,DeVince Boykins,SR,G,Georgia Southern,Sun Belt,30,454,46,107,29,65,17,42,11,42,19,45,64,29,14,3,39,58,120
Georgia Southern8,8,Shawn O'Connell,FR,F,Georgia Southern,Sun Belt,31,440,30,55,30,54,0,1,33,51,46,56,102,12,11,14,13,97,93
Georgia Southern9,9,Montae Glenn,FR,F,Georgia Southern,Sun Belt,25,327,46,78,46,77,0,1,21,28,40,53,93,5,7,8,15,60,113
Georgia Southern10,10,Jason Burnell,FR,F,Georgia Southern,Sun Belt,23,185,25,74,13,33,12,41,4,7,17,21,38,7,8,5,10,25,66
Georgia Southern11,11,Jonathan Sanks,FR,G,Georgia Southern,Sun Belt,19,128,18,42,12,20,6,22,15,23,2,8,10,5,3,1,7,22,57
Georgia Southern12,12,Aubrey McRae,FR,G,Georgia Southern,Sun Belt,11,38,8,21,7,10,1,11,0,2,3,2,5,2,7,0,1,11,17
Georgia Southern13,13,D.J. Suter,SR,G,Georgia Southern,Sun Belt,2,5,1,2,1,1,0,1,0,0,0,0,0,0,0,0,0,0,2
Georgia Southern14,14,James Holder,JR,G,Georgia Southern,Sun Belt,2,5,1,5,0,1,1,4,0,0,0,0,0,0,0,0,0,0,3
Georgia State1,1,Kevin Ware,SR,G,Georgia State,Sun Belt,30,1065,115,273,93,211,22,62,97,123,11,101,112,92,37,14,78,70,349
Georgia State2,2,Jeremy Hollowell,JR,F,Georgia State,Sun Belt,30,958,152,349,115,238,37,111,102,126,30,116,146,50,31,13,56,88,443
Georgia State3,3,Markus Crider,SR,F,Georgia State,Sun Belt,30,870,101,187,101,185,0,2,66,98,38,112,150,29,25,16,44,96,268
Georgia State4,4,T.J. Shipes,SR,F,Georgia State,Sun Belt,30,773,68,115,68,115,0,0,24,54,43,109,152,5,22,24,28,93,160
Georgia State5,5,Isaiah Williams,SO,G,Georgia State,Sun Belt,30,747,89,232,49,124,40,108,64,83,14,49,63,80,26,1,47,41,282
Georgia State6,6,Isaiah Dennis,JR,G,Georgia State,Sun Belt,29,511,47,81,46,79,1,2,17,40,12,35,47,54,20,8,33,53,112
Georgia State7,7,Jeff Thomas,FR,G,Georgia State,Sun Belt,30,492,64,173,24,65,40,108,16,20,21,39,60,12,11,6,14,44,184
Georgia State8,8,Jordan Session,SO,F,Georgia State,Sun Belt,29,273,32,78,31,75,1,3,10,17,14,32,46,8,11,6,15,41,75
Georgia State9,9,Malik Benlevi,FR,G,Georgia State,Sun Belt,28,232,19,63,15,38,4,25,8,17,12,17,29,6,6,3,10,28,50
Georgia State10,10,Austin Donaldson,FR,G,Georgia State,Sun Belt,17,137,15,30,14,26,1,4,8,20,6,14,20,16,10,0,16,20,39
Georgia State11,11,Jalen Brown,SR,F,Georgia State,Sun Belt,11,36,3,14,0,3,3,11,0,0,2,6,8,0,0,0,1,4,9
Georgia Tech1,1,Marcus Georges-Hunt,SR,F,Georgia Tech,ACC,33,1066,161,357,127,253,34,104,194,236,28,82,110,103,28,13,69,86,550
Georgia Tech2,2,Adam Smith,SR,G,Georgia Tech,ACC,33,998,168,418,67,175,101,243,56,71,12,64,76,60,14,0,40,53,493
Georgia Tech3,3,Charles Mitchell,SR,F,Georgia Tech,ACC,33,823,137,269,137,269,0,0,54,91,124,199,323,20,22,14,56,87,328
Georgia Tech4,4,Nick Jacobs,SR,F,Georgia Tech,ACC,33,750,147,307,147,307,0,0,57,74,61,129,190,9,13,21,45,59,351
Georgia Tech5,5,Quinton Stephens,JR,F,Georgia Tech,ACC,33,660,59,159,31,71,28,88,20,28,37,87,124,34,10,15,30,49,166
Georgia Tech6,6,Josh Heath,JR,G,Georgia Tech,ACC,31,543,28,74,24,58,4,16,23,28,11,24,35,88,16,2,27,52,83
Georgia Tech7,7,Ben Lammers,SO,C,Georgia Tech,ACC,33,486,51,79,51,79,0,0,15,30,43,90,133,16,13,44,15,60,117
Georgia Tech8,8,James White,SR,F,Georgia Tech,ACC,33,485,55,109,55,109,0,0,10,25,61,87,148,14,10,27,21,82,120
Georgia Tech9,9,Tadric Jackson,SO,G,Georgia Tech,ACC,33,458,54,146,38,85,16,61,29,50,7,31,38,42,15,3,29,45,153
Georgia Tech10,10,Travis Jorgenson,SO,G,Georgia Tech,ACC,26,327,20,58,11,22,9,36,3,8,2,22,24,57,8,0,18,18,52
Georgia Tech11,11,Corey Heyward,JR,G,Georgia Tech,ACC,6,19,1,4,1,3,0,1,0,0,0,1,1,0,1,0,1,0,2
Gonzaga1,1,Kyle Wiltjer,SR,F,Gonzaga,WCC,33,1110,239,488,158,297,81,191,124,143,56,157,213,46,12,27,68,58,683
Gonzaga2,2,Domantas Sabonis,SO,F,Gonzaga,WCC,33,1040,214,347,210,335,4,12,142,185,97,286,383,56,19,23,82,105,574
Gonzaga3,3,Kyle Dranginis,SR,G,Gonzaga,WCC,33,1011,78,177,41,75,37,102,23,40,47,96,143,105,32,12,29,78,216
Gonzaga4,4,Josh Perkins,FR,G,Gonzaga,WCC,33,1009,119,271,74,157,45,114,57,82,20,92,112,131,38,11,66,93,340
Gonzaga5,5,Eric McClellan,SR,G,Gonzaga,WCC,33,884,120,257,88,160,32,97,77,99,22,84,106,63,27,7,50,74,349
Gonzaga6,6,Silas Melson,SO,G,Gonzaga,WCC,33,705,73,185,44,96,29,89,48,61,6,75,81,28,20,5,22,67,223
Gonzaga7,7,Bryan Alberts,FR,G,Gonzaga,WCC,32,383,30,75,7,18,23,57,5,6,9,33,42,9,7,2,7,31,88
Gonzaga8,8,Ryan Edwards,SO,C,Gonzaga,WCC,29,263,28,57,28,56,0,1,25,36,28,38,66,4,1,8,18,51,81
Gonzaga9,9,Przemek Karnowski,SR,C,Gonzaga,WCC,5,124,19,32,19,32,0,0,6,13,5,22,27,6,4,3,12,10,44
Gonzaga10,10,Dustin Triano,SO,G,Gonzaga,WCC,16,52,8,14,2,2,6,12,3,5,4,5,9,6,1,0,2,8,25
Gonzaga11,11,Rem Bakamus,JR,G,Gonzaga,WCC,13,27,1,4,0,0,1,4,4,6,1,7,8,2,4,0,2,1,7
Grambling1,1,Nigel Ribeiro,FR,G,Grambling,SWAC,31,917,125,302,85,171,40,131,48,75,11,75,86,67,46,2,64,75,338
Grambling2,2,Mark Gray,SR,F,Grambling,SWAC,31,830,65,162,46,97,19,65,63,89,32,107,139,16,15,5,52,69,212
Grambling3,3,Ervin Mitchell,JR,G,Grambling,SWAC,27,656,108,245,82,159,26,86,75,112,19,88,107,32,23,8,33,58,317
Grambling4,4,Deonte Hearns,JR,G,Grambling,SWAC,22,653,89,189,89,184,0,5,74,120,52,99,151,18,21,5,62,78,252
Grambling5,5,Michael Bethea Jr.,JR,G,Grambling,SWAC,31,589,52,174,19,45,33,129,26,32,12,51,63,20,26,3,24,39,163
Grambling6,6,Chase Cormier,JR,G,Grambling,SWAC,27,510,10,40,7,29,3,11,21,43,12,34,46,51,26,0,39,56,44
Grambling7,7,Remond Brown,JR,G,Grambling,SWAC,15,432,58,130,51,99,7,31,39,60,21,62,83,32,11,8,32,40,162
Grambling8,8,Arnold Richmond,SR,G,Grambling,SWAC,31,420,47,123,40,87,7,36,52,77,9,26,35,35,19,2,57,42,153
Grambling9,9,Ugur Hortum,JR,C,Grambling,SWAC,27,410,26,78,20,58,6,20,17,27,15,53,68,11,5,4,26,49,75
Grambling10,10,Kyle Williams,SO,C,Grambling,SWAC,29,299,21,39,21,39,0,0,10,24,15,28,43,3,5,9,19,40,52
Grambling11,11,Carlton Lowe,JR,G,Grambling,SWAC,28,218,28,64,17,25,11,39,20,26,14,17,31,7,4,0,6,32,87
Grambling12,12,Valerio Altheimer,JR,G,Grambling,SWAC,26,167,18,36,18,34,0,2,9,19,17,31,48,6,9,1,4,18,45
Grambling13,13,Jack Ocwieja,JR,C,Grambling,SWAC,16,148,11,24,11,23,0,1,2,2,4,13,17,0,0,4,5,19,24
Grand Canyon1,1,Dewayne Russell,SR,G,Grand Canyon,WAC,32,992,109,259,94,226,15,33,78,114,18,78,96,171,44,3,72,63,311
Grand Canyon2,2,Joshua Braun,SO,G,Grand Canyon,WAC,32,977,139,312,68,138,71,174,193,223,54,117,171,36,25,22,40,67,542
Grand Canyon3,3,Grandy Glaze,SR,F,Grand Canyon,WAC,31,811,187,311,187,301,0,10,63,103,71,195,266,24,15,0,48,48,437
Grand Canyon4,4,Gerard Martin,FR,G,Grand Canyon,WAC,32,734,45,118,15,42,30,76,20,25,11,71,82,81,30,13,37,72,140
Grand Canyon5,5,Keonta Vernon,JR,F,Grand Canyon,WAC,32,605,92,195,91,193,1,2,43,80,74,102,176,16,19,15,53,114,228
Grand Canyon6,6,Matt Jackson,SO,F,Grand Canyon,WAC,31,598,69,163,44,89,25,74,20,33,23,89,112,33,9,12,26,59,183
Grand Canyon7,7,De'Andre Davis,SO,G,Grand Canyon,WAC,31,525,64,137,61,119,3,18,68,98,24,38,62,62,24,5,49,52,199
Grand Canyon8,8,Ryan Majerle,SR,G,Grand Canyon,WAC,32,471,47,113,7,18,40,95,15,19,6,29,35,15,7,7,10,27,149
Grand Canyon9,9,Dominic Magee,FR,G,Grand Canyon,WAC,20,324,52,136,43,104,9,32,37,61,8,36,44,33,16,0,29,28,150
Grand Canyon10,10,Uros Ljeskovic,SR,F,Grand Canyon,WAC,22,158,23,46,23,46,0,0,5,18,16,9,25,2,6,2,8,36,51
Grand Canyon11,11,Boubacar Toure,FR,C,Grand Canyon,WAC,8,115,13,29,13,28,0,1,9,19,9,21,30,0,1,4,11,20,35
Grand Canyon12,12,Grant White,SR,G,Grand Canyon,WAC,14,72,9,29,3,9,6,20,3,6,0,6,6,4,0,1,1,6,27
Grand Canyon13,13,Jevon Estelle,SR,F,Grand Canyon,WAC,11,43,2,13,2,7,0,6,3,4,2,4,6,2,1,0,2,5,7
Green Bay1,1,Carrington Love,SR,G,Green Bay,Horizon,35,1139,203,480,119,239,84,241,130,215,20,77,97,123,89,10,59,67,620
Green Bay2,2,Jordan Fouse,SR,G,Green Bay,Horizon,35,1104,154,370,113,242,41,128,98,132,73,221,294,116,73,48,76,105,447
Green Bay3,3,Charles Cooper,JR,G,Green Bay,Horizon,35,946,159,335,151,300,8,35,159,230,59,136,195,53,37,6,70,63,485
Green Bay4,4,Khalil Small,SO,G,Green Bay,Horizon,35,829,125,277,89,182,36,95,58,83,56,72,128,36,33,9,44,102,344
Green Bay5,5,Kenneth Lowe,JR,F,Green Bay,Horizon,35,753,103,192,103,192,0,0,38,79,63,76,139,41,34,41,50,101,244
Green Bay6,6,Turner Botz,JR,G,Green Bay,Horizon,35,671,63,175,28,77,35,98,45,62,28,82,110,32,20,4,22,64,206
Green Bay7,7,Jamar Hurdle,JR,F,Green Bay,Horizon,34,499,87,174,77,150,10,24,41,57,48,63,111,18,16,36,26,81,225
Green Bay8,8,Tevin Findlay,JR,G,Green Bay,Horizon,34,452,57,119,40,83,17,36,34,50,10,37,47,38,22,4,28,38,165
Green Bay9,9,Anthony Brown,FR,G,Green Bay,Horizon,28,321,22,53,16,41,6,12,24,36,5,32,37,19,15,0,19,32,74
Green Bay10,10,Kerem Kanter,SO,F,Green Bay,Horizon,27,255,41,86,37,65,4,21,18,27,21,39,60,5,1,2,10,36,104
Green Bay11,11,Avery Brown,FR,G,Green Bay,Horizon,14,78,9,27,4,14,5,13,2,8,5,8,13,6,4,0,3,2,25
Green Bay12,12,Henry Uwadiae,JR,F,Green Bay,Horizon,11,28,4,6,4,6,0,0,1,5,6,6,12,0,0,1,6,10,9
Hampton1,1,Reggie Johnson,SR,G,Hampton,MEAC,31,1116,188,506,134,327,54,179,138,192,38,77,115,127,53,3,87,95,568
Hampton2,2,Brian Darden,SR,G,Hampton,MEAC,31,976,124,358,44,119,80,239,81,96,8,56,64,59,25,1,54,75,409
Hampton3,3,Quinton Chievous,SR,G,Hampton,MEAC,26,891,178,312,162,257,16,55,71,147,85,202,287,54,15,4,72,62,443
Hampton4,4,Lawrence Cooks,JR,G,Hampton,MEAC,30,823,74,182,39,75,35,107,56,65,13,95,108,45,19,3,42,74,239
Hampton5,5,Dionte Adams,SR,F,Hampton,MEAC,31,598,62,125,62,122,0,3,38,60,76,105,181,18,13,38,28,76,162
Hampton6,6,Jervon Pressley,SR,F,Hampton,MEAC,27,558,64,139,64,139,0,0,54,100,58,103,161,17,3,47,57,89,182
Hampton7,7,Kalin Fisher,FR,G,Hampton,MEAC,31,398,36,113,26,68,10,45,33,55,17,28,45,20,10,2,18,36,115
Hampton8,8,Charles Wilson-Fisher,SO,F,Hampton,MEAC,31,318,33,68,30,59,3,9,12,18,30,48,78,6,11,6,26,50,81
Hampton9,9,Akim Mitchell,FR,G,Hampton,MEAC,29,318,18,56,15,39,3,17,28,35,19,36,55,14,7,1,12,32,67
Hampton10,10,Imani Miller,FR,G,Hampton,MEAC,23,118,2,9,2,9,0,0,4,8,5,9,14,12,6,0,10,16,8
Hampton11,11,Trevond Barnes,FR,F,Hampton,MEAC,13,81,8,16,8,15,0,1,2,8,9,10,19,0,3,6,4,14,18
Hampton12,12,Devon Oakley,FR,G,Hampton,MEAC,14,81,2,9,2,8,0,1,5,7,3,10,13,3,2,1,3,10,9
Hampton13,13,Branden Aughburns,FR,F,Hampton,MEAC,12,31,2,12,1,11,1,1,3,4,4,5,9,0,0,5,1,7,8
Hampton14,14,Gregory Hayden,JR,G,Hampton,MEAC,9,18,2,6,1,4,1,2,4,10,0,1,1,2,1,0,6,2,9
Hartford1,1,Pancake Thomas,SR,G,Hartford,AEC,30,1038,178,407,97,217,81,190,129,156,30,163,193,84,36,6,53,72,566
Hartford2,2,Jalen Ross,JR,G,Hartford,AEC,33,830,104,254,62,142,42,112,86,111,16,88,104,67,29,1,45,61,336
Hartford3,3,George Blagojevic,FR,F,Hartford,AEC,31,814,103,252,71,161,32,91,54,80,37,91,128,46,24,15,66,87,292
Hartford4,4,Justin Graham,JR,G,Hartford,AEC,30,766,69,209,45,126,24,83,48,71,9,48,57,61,35,1,58,55,210
Hartford5,5,J.R. Lynch,FR,G,Hartford,AEC,32,620,55,128,32,60,23,68,33,44,6,43,49,34,24,1,26,74,166
Hartford6,6,Taylor Dyson,SR,G,Hartford,AEC,28,540,67,178,21,58,46,120,24,29,11,52,63,17,14,2,28,45,204
Hartford7,7,Evan Cooper,JR,G,Hartford,AEC,33,520,59,148,20,40,39,108,31,36,10,37,47,33,16,2,25,65,188
Hartford8,8,Jason Dunne,FR,G,Hartford,AEC,33,504,44,102,32,52,12,50,19,27,19,36,55,26,20,2,21,62,119
Hartford9,9,Jack Hobbs,SO,F,Hartford,AEC,33,467,47,111,29,47,18,64,12,26,24,61,85,15,11,8,15,69,124
Hartford10,10,TreVaughn Wilkerson,FR,F,Hartford,AEC,25,294,25,44,25,43,0,1,10,14,13,42,55,9,6,20,23,60,60
Hartford11,11,Dougal Weir,JR,C,Hartford,AEC,24,155,5,9,5,8,0,1,2,2,7,15,22,5,3,2,4,24,12
Hartford12,12,John Carroll,SO,F,Hartford,AEC,5,123,21,54,19,46,2,8,12,17,9,19,28,10,1,3,8,21,56
Harvard1,1,Agunwa Okolie,SR,G,Harvard,Ivy,30,930,120,224,115,211,5,13,63,100,67,112,179,60,34,21,55,73,308
Harvard2,2,Corey Johnson,FR,G,Harvard,Ivy,29,831,96,249,22,63,74,186,17,25,13,54,67,43,13,8,39,57,283
Harvard3,3,Corbin Miller,JR,G,Harvard,Ivy,30,739,71,202,14,49,57,153,15,24,7,46,53,40,17,2,35,24,214
Harvard4,4,Zena Edosomwan,JR,C,Harvard,Ivy,28,729,147,290,147,290,0,0,75,153,73,202,275,54,13,35,59,82,369
Harvard5,5,Evan Cummins,SR,F,Harvard,Ivy,30,712,84,137,84,137,0,0,17,37,45,97,142,65,14,44,43,76,185
Harvard6,6,Tommy McCarthy,FR,G,Harvard,Ivy,28,694,74,220,33,105,41,115,55,65,7,38,45,101,24,1,81,81,244
Harvard7,7,Patrick Steeves,SR,G,Harvard,Ivy,26,590,83,185,50,112,33,73,38,57,15,84,99,62,20,17,55,42,237
Harvard8,8,Chris Egi,SO,F,Harvard,Ivy,25,287,17,38,17,38,0,0,8,29,15,33,48,13,6,16,20,46,42
Harvard9,9,Weisner Perez,FR,F,Harvard,Ivy,29,246,26,68,22,54,4,14,19,27,24,39,63,4,2,3,13,27,75
Harvard10,10,Andre Chatfield,SO,G,Harvard,Ivy,21,175,9,19,6,10,3,9,2,3,4,18,22,7,6,2,10,21,23
Harvard11,11,Balsa Dragovic,FR,F,Harvard,Ivy,9,44,5,11,3,7,2,4,4,4,4,9,13,1,0,1,4,7,16
Harvard12,12,Zach Yoshor,SO,G,Harvard,Ivy,7,19,1,2,0,0,1,2,0,2,0,4,4,0,0,0,0,0,3
Harvard13,13,Matt Fraschilla,JR,G,Harvard,Ivy,2,17,1,1,1,1,0,0,0,0,0,1,1,1,1,0,3,1,2
Hawaii1,1,Roderick Bobbitt,SR,G,Hawaii,Big West,31,1055,117,302,63,147,54,155,123,152,33,96,129,169,68,6,90,81,411
Hawaii2,2,Aaron Valdes,JR,G,Hawaii,Big West,28,859,142,292,100,164,42,128,85,125,42,113,155,69,34,18,41,56,411
Hawaii3,3,Quincy Smith,SR,G,Hawaii,Big West,32,841,92,207,75,150,17,57,45,103,27,75,102,81,55,4,46,65,246
Hawaii4,4,Stefan Jankovic,JR,F,Hawaii,Big West,31,769,162,291,132,215,30,76,132,172,52,153,205,38,20,38,56,92,486
Hawaii5,5,Mike Thomas,JR,F,Hawaii,Big West,32,685,89,175,84,147,5,28,58,105,59,112,171,28,11,11,46,90,241
Hawaii6,6,Sai Tummala,SR,G,Hawaii,Big West,32,567,74,169,32,64,42,105,19,30,35,64,99,26,9,8,26,83,209
Hawaii7,7,Isaac Fleming,SO,G,Hawaii,Big West,23,542,73,164,46,76,27,88,46,62,16,40,56,54,29,1,36,49,219
Hawaii8,8,Stefan Jovanovic,JR,C,Hawaii,Big West,32,491,64,121,64,121,0,0,33,45,26,104,130,8,8,34,35,56,161
Hawaii9,9,Sheriff Drammeh,FR,G,Hawaii,Big West,30,385,16,46,7,18,9,28,10,18,4,27,31,14,8,0,9,46,51
Hawaii10,10,Niko Filipovich,SO,G,Hawaii,Big West,22,115,6,23,4,6,2,17,12,13,1,10,11,9,6,0,12,17,26
Hawaii11,11,Zach Buscher,FR,G,Hawaii,Big West,13,39,5,9,5,6,0,3,0,2,0,6,6,4,1,0,2,5,10
Hawaii12,12,Dyrbe Enos,JR,G,Hawaii,Big West,14,28,3,13,1,3,2,10,1,2,1,4,5,1,2,0,1,2,9
High Point1,1,Lorenzo Cugini,SR,F,High Point,Big South,31,861,120,268,55,120,65,148,30,35,21,87,108,41,11,2,31,56,335
High Point2,2,Adam Weary,SR,G,High Point,Big South,30,835,138,269,120,222,18,47,79,104,28,75,103,94,37,7,50,77,373
High Point3,3,John Brown,SR,F,High Point,Big South,28,830,212,352,211,351,1,1,124,177,91,108,199,62,48,49,48,60,549
High Point4,4,Anthony Lindauer,JR,G,High Point,Big South,31,800,86,213,43,101,43,112,40,45,6,88,94,58,33,8,40,58,255
High Point5,5,Haiishen McIntyre,SR,G,High Point,Big South,31,686,49,127,44,108,5,19,57,75,14,62,76,103,51,4,30,57,160
High Point6,6,Andre Fox,FR,G,High Point,Big South,30,464,49,137,34,83,15,54,44,52,26,38,64,18,15,7,39,38,157
High Point7,7,Austin White,SO,G,High Point,Big South,31,462,47,96,40,78,7,18,38,47,6,36,42,23,15,1,18,39,139
High Point8,8,Jorge Perez-Laham,JR,G,High Point,Big South,23,373,27,71,15,41,12,30,3,7,8,33,41,47,12,3,19,30,69
High Point9,9,Tarique Thompson,JR,F,High Point,Big South,27,329,55,109,54,106,1,3,20,26,33,43,76,9,13,5,17,41,131
High Point10,10,Ricky Madison,FR,G,High Point,Big South,26,260,33,73,33,69,0,4,38,56,27,34,61,5,7,5,18,49,104
High Point11,11,Miles Bowman,JR,F,High Point,Big South,14,195,36,55,32,45,4,10,28,30,20,40,60,8,3,3,9,22,104
High Point12,12,DeAndre Barber,SO,G,High Point,Big South,19,111,5,10,2,4,3,6,1,2,0,7,7,9,2,0,4,10,14
High Point13,13,K.J. James,SO,F,High Point,Big South,9,23,2,4,2,2,0,2,2,4,3,4,7,1,0,0,2,2,6
High Point14,14,Dexter Gooding,FR,G,High Point,Big South,7,7,4,6,3,3,1,3,0,0,0,2,2,0,0,0,0,1,9
Hofstra1,1,Juan'ya Green,SR,G,Hofstra,CAA,33,1242,163,419,99,240,64,179,190,238,24,120,144,233,54,17,97,77,580
Hofstra2,2,Brian Bernardi,JR,G,Hofstra,CAA,33,1194,133,332,46,112,87,220,58,67,5,55,60,50,23,3,45,49,411
Hofstra3,3,Denton Koon,SR,F,Hofstra,CAA,33,1172,132,313,81,167,51,146,54,79,60,157,217,53,18,17,54,64,369
Hofstra4,4,Ameen Tanksley,SR,G,Hofstra,CAA,33,1146,166,397,106,230,60,167,135,171,65,108,173,47,30,8,65,76,527
Hofstra5,5,Rokas Gustys,SO,F,Hofstra,CAA,33,996,187,282,187,282,0,0,71,168,138,291,429,29,30,40,56,110,445
Hofstra6,6,Desure Buie,FR,G,Hofstra,CAA,33,420,37,112,26,64,11,48,17,25,4,28,32,49,27,3,23,42,102
Hofstra7,7,Malik Nichols,SR,G,Hofstra,CAA,20,361,41,80,38,70,3,10,19,40,42,65,107,27,18,4,25,70,104
Hofstra8,8,Andre Walker,SO,F,Hofstra,CAA,24,118,9,22,9,22,0,0,4,7,10,20,30,4,3,13,8,24,22
Hofstra9,9,Justin Wright-Foreman,FR,G,Hofstra,CAA,26,101,16,36,13,20,3,16,6,11,0,8,8,4,4,2,6,13,41
Holy Cross1,1,Malachi Alexander,JR,F,Holy Cross,Patriot,33,1079,133,279,87,173,46,106,83,130,54,130,184,89,29,4,55,88,395
Holy Cross2,2,Anthony Thompson,JR,G,Holy Cross,Patriot,33,1065,66,239,25,81,41,158,62,79,14,68,82,87,37,0,33,70,235
Holy Cross3,3,Karl Charles,FR,F,Holy Cross,Patriot,33,952,106,250,79,154,27,96,119,150,42,99,141,83,36,19,72,68,358
Holy Cross4,4,Cullen Hamilton,SR,G,Holy Cross,Patriot,33,931,104,262,76,173,28,89,50,63,16,59,75,59,23,1,39,53,286
Holy Cross5,5,Robert Champion,JR,G,Holy Cross,Patriot,33,899,131,305,79,157,52,148,66,97,23,137,160,51,34,6,52,88,380
Holy Cross6,6,Matt Husek,JR,C,Holy Cross,Patriot,33,598,75,166,54,110,21,56,27,37,19,82,101,37,10,29,39,73,198
Holy Cross7,7,Matt Zignorski,FR,G,Holy Cross,Patriot,30,416,40,107,21,52,19,55,11,15,6,22,28,20,17,1,21,24,110
Holy Cross8,8,Eric Green,SR,G,Holy Cross,Patriot,17,278,35,75,33,71,2,4,6,16,12,27,39,8,11,2,6,10,78
Holy Cross9,9,Jehyve Floyd,FR,F,Holy Cross,Patriot,27,255,36,57,36,57,0,0,7,22,17,24,41,12,10,20,21,53,79
Holy Cross10,10,Pat Benzan,FR,G,Holy Cross,Patriot,26,149,6,23,6,20,0,3,10,16,6,16,22,12,5,0,7,16,22
Holy Cross11,11,Marcellis Perkins,FR,F,Holy Cross,Patriot,17,42,2,10,2,6,0,4,2,8,5,4,9,0,1,0,1,5,6
Holy Cross12,12,Isaiah Baker,SR,F,Holy Cross,Patriot,9,33,2,5,2,5,0,0,2,8,2,3,5,1,0,1,3,6,6
Holy Cross13,13,Patrick Rielly,JR,G,Holy Cross,Patriot,10,11,1,4,1,3,0,1,1,3,0,4,4,0,0,0,0,0,3
Houston1,1,Damyean Dotson,JR,G,Houston,AAC,31,957,158,313,96,145,62,168,53,63,62,149,211,39,20,6,32,61,431
Houston2,2,Devonta Pollard,SR,F,Houston,AAC,31,919,146,309,145,307,1,2,135,181,58,120,178,48,29,20,50,76,428
Houston3,3,Galen Robinson Jr.,FR,G,Houston,AAC,31,755,95,207,78,150,17,57,41,59,9,65,74,106,29,3,49,62,248
Houston4,4,LeRon Barnes,SR,G,Houston,AAC,28,697,67,131,35,57,32,74,10,19,45,106,151,29,19,14,18,61,176
Houston5,5,Robert Gray Jr.,SO,G,Houston,AAC,25,670,148,336,101,199,47,137,65,94,11,46,57,38,30,5,35,52,408
Houston6,6,Ronnie Johnson,JR,G,Houston,AAC,30,667,93,232,68,165,25,67,70,88,19,59,78,87,22,1,48,49,281
Houston7,7,Danrad Knowles,JR,F,Houston,AAC,31,559,77,136,73,119,4,17,34,68,63,55,118,7,9,28,31,79,192
Houston8,8,Kyle Meyer,JR,C,Houston,AAC,31,430,28,64,27,53,1,11,18,27,33,53,86,14,12,19,23,60,75
Houston9,9,Bertrand Nkali,JR,F,Houston,AAC,23,204,11,18,11,18,0,0,11,22,29,21,50,2,4,18,5,39,33
Houston10,10,Xavier Dupree,JR,F,Houston,AAC,20,163,11,31,3,11,8,20,0,0,10,26,36,9,5,4,11,21,30
Houston11,11,Wes VanBeck,SO,G,Houston,AAC,19,157,22,47,12,21,10,26,18,24,8,18,26,9,6,2,9,16,72
Houston12,12,Eric Weary,SR,G,Houston,AAC,18,120,14,38,10,17,4,21,1,3,10,10,20,10,1,0,5,18,33
Houston13,13,L.J. Rose,SR,G,Houston,AAC,2,27,2,6,0,1,2,5,1,2,0,2,2,4,0,0,0,2,7
Houston Baptist1,1,Anthony Odunsi,SR,G,Houston Baptist,Southland,32,917,152,315,140,277,12,38,248,296,24,116,140,119,38,1,109,67,564
Houston Baptist2,2,Colter Lasher,JR,F,Houston Baptist,Southland,31,806,131,278,98,181,33,97,32,55,30,116,146,61,29,16,53,54,327
Houston Baptist3,3,Reveal Chukwujekwu,JR,G,Houston Baptist,Southland,33,778,94,186,83,157,11,29,76,105,53,114,167,49,19,4,66,52,275
Houston Baptist4,4,Jourdan Stickler,SR,G,Houston Baptist,Southland,30,679,80,204,28,87,52,117,20,24,20,40,60,31,12,1,33,44,232
Houston Baptist5,5,Caleb Crayton,SR,G,Houston Baptist,Southland,33,607,61,142,41,75,20,67,39,61,26,62,88,37,12,2,42,69,181
Houston Baptist6,6,Alex Fountain,JR,F,Houston Baptist,Southland,32,511,52,127,38,90,14,37,47,56,23,66,89,22,11,13,16,51,165
Houston Baptist7,7,Josh Ibarra,SO,C,Houston Baptist,Southland,22,486,102,160,102,160,0,0,25,50,41,104,145,21,4,30,36,68,229
Houston Baptist8,8,Asa Cantwell,FR,G,Houston Baptist,Southland,33,472,55,139,8,16,47,123,14,19,4,33,37,27,14,0,20,48,171
Houston Baptist9,9,Trey Patterson,SO,G,Houston Baptist,Southland,31,384,39,66,38,57,1,9,26,57,8,27,35,39,17,2,34,49,105
Houston Baptist10,10,Isaiah Robinson,FR,C,Houston Baptist,Southland,26,338,34,54,34,53,0,1,13,23,27,69,96,20,8,53,13,47,81
Houston Baptist11,11,Cody Stetler,JR,C,Houston Baptist,Southland,23,321,43,84,42,81,1,3,26,39,23,40,63,14,4,7,19,55,113
Houston Baptist12,12,Stephen O'Suji,SO,G,Houston Baptist,Southland,14,122,11,29,9,23,2,6,4,9,7,10,17,9,5,0,16,10,28
Houston Baptist13,13,Terry Harris,SO,G,Houston Baptist,Southland,9,112,15,35,14,27,1,8,16,24,6,13,19,2,2,1,6,12,47
Houston Baptist14,14,William Gates,SO,G,Houston Baptist,Southland,3,38,4,12,3,7,1,5,1,2,0,2,2,1,1,0,4,1,10
Houston Baptist15,15,Evan Anderson,FR,G,Houston Baptist,Southland,7,21,3,6,2,4,1,2,4,6,2,4,6,3,0,1,4,2,11
Howard1,1,James Daniel,JR,G,Howard,MEAC,30,1115,226,582,146,341,80,241,280,331,22,44,66,84,59,7,123,62,812
Howard2,2,Damon Collins,JR,G,Howard,MEAC,30,994,106,283,95,233,11,50,79,107,26,110,136,62,34,5,74,60,302
Howard3,3,Marcel Boyd,JR,C,Howard,MEAC,28,877,100,189,100,189,0,0,90,158,85,192,277,18,12,42,66,87,290
Howard4,4,Tyler Stone,JR,F,Howard,MEAC,30,781,71,186,65,155,6,31,68,97,54,117,171,13,16,20,46,90,216
Howard5,5,Dalique Mingo,SO,G,Howard,MEAC,31,573,47,123,42,91,5,32,36,49,34,56,90,23,23,1,26,60,135
Howard6,6,Kofi Andoh,JR,G,Howard,MEAC,32,551,42,112,36,93,6,19,54,66,25,60,85,15,15,5,32,64,144
Howard7,7,Keon Hill,JR,G,Howard,MEAC,32,413,36,112,19,60,17,52,6,10,6,18,24,36,7,1,39,35,95
Howard8,8,Jalen Jones,FR,F,Howard,MEAC,29,361,28,50,26,46,2,4,7,21,30,49,79,6,12,3,14,50,65
Howard9,9,Solomon Mangham,JR,F,Howard,MEAC,14,338,40,99,29,64,11,35,16,26,33,45,78,2,5,5,13,38,107
Howard10,10,James Miller,JR,G,Howard,MEAC,5,138,29,58,24,43,5,15,12,14,8,14,22,8,5,3,14,16,75
Howard11,11,Cameron Lewis,FR,F,Howard,MEAC,18,134,8,19,8,19,0,0,8,14,9,15,24,1,5,2,7,31,24
Howard12,12,Oliver Ellison,SR,C,Howard,MEAC,11,130,13,15,13,15,0,0,4,11,7,23,30,2,3,5,6,28,30
Howard13,13,Saleem Little,FR,F,Howard,MEAC,9,28,2,8,1,4,1,4,3,4,1,5,6,0,0,3,2,1,8
Howard14,14,Patrick Speller,JR,G,Howard,MEAC,11,18,2,4,2,3,0,1,2,4,1,3,4,0,0,0,0,2,6
IPFW1,1,Max Landis,SR,G,IPFW,Summit,32,1190,191,418,70,153,121,265,121,149,5,62,67,120,29,1,66,40,624
IPFW2,2,John Konchar,FR,G,IPFW,Summit,33,1171,159,270,130,206,29,64,84,117,85,209,294,88,65,9,50,80,431
IPFW3,3,Joe Reed,SR,F,IPFW,Summit,33,961,123,226,105,175,18,51,78,124,55,104,159,40,18,19,39,85,342
IPFW4,4,Michael Calder,SR,G,IPFW,Summit,33,850,112,282,61,147,51,135,66,96,18,109,127,81,18,4,80,72,341
IPFW5,5,DeAngelo Stewart,JR,F,IPFW,Summit,33,690,92,210,32,70,60,140,30,43,20,98,118,26,10,14,27,51,274
IPFW6,6,Mo Evans,JR,G,IPFW,Summit,18,558,103,214,55,101,48,113,50,59,2,64,66,91,20,3,42,49,304
IPFW7,7,Brent Calhoun,JR,F,IPFW,Summit,33,517,62,128,62,128,0,0,14,24,41,95,136,27,8,36,53,95,138
IPFW8,8,Racine Talla,SO,F,IPFW,Summit,31,319,16,68,12,46,4,22,17,28,25,36,61,11,6,18,24,47,53
IPFW9,9,Charles Ruise Jr.,FR,G,IPFW,Summit,30,276,34,96,26,62,8,34,8,12,5,30,35,14,6,3,8,39,84
IPFW10,10,Kason Harrell,FR,G,IPFW,Summit,15,72,12,25,4,12,8,13,5,6,2,7,9,3,1,1,4,8,37
IPFW11,11,Andrew Poulter,JR,F,IPFW,Summit,11,39,8,17,8,17,0,0,0,2,7,4,11,0,0,0,1,4,16
IPFW12,12,Trevor Osborn,JR,G,IPFW,Summit,6,7,1,2,1,1,0,1,0,0,1,2,3,2,0,0,1,2,2
IUPUI1,1,Darell Combs,JR,G,IUPUI,Summit,31,950,165,386,107,247,58,139,117,155,12,58,70,68,31,1,101,93,505
IUPUI2,2,Marcellus Barksdale,SR,G,IUPUI,Summit,32,928,97,218,88,185,9,33,70,95,42,120,162,51,50,30,57,78,273
IUPUI3,3,Matt O'Leary,JR,F,IUPUI,Summit,32,896,128,264,100,163,28,101,45,78,39,151,190,69,32,10,56,70,329
IUPUI4,4,Mason Archie,SR,G,IUPUI,Summit,32,807,51,156,33,85,18,71,38,51,28,68,96,29,14,2,33,73,158
IUPUI5,5,Jordan Pickett,SO,G,IUPUI,Summit,26,672,81,211,58,139,23,72,59,72,9,37,46,45,20,3,38,41,244
IUPUI6,6,Nick Osborne,JR,F,IUPUI,Summit,30,612,101,223,85,187,16,36,26,35,60,122,182,11,13,13,34,103,244
IUPUI7,7,Aaron Brennan,SO,F,IUPUI,Summit,32,569,55,144,54,135,1,9,26,31,37,78,115,33,12,11,31,68,137
IUPUI8,8,T.J. Henderson,FR,G,IUPUI,Summit,32,522,49,129,27,66,22,63,27,39,5,48,53,35,30,2,44,48,147
IUPUI9,9,Evan Hall,FR,F,IUPUI,Summit,23,383,50,97,49,96,1,1,19,47,41,50,91,14,10,7,17,67,120
IUPUI10,10,John Hubler,SO,G,IUPUI,Summit,13,65,4,14,0,3,4,11,1,3,0,3,3,0,1,2,4,6,13
IUPUI11,11,Leo Svete,SO,G,IUPUI,Summit,6,41,4,13,1,3,3,10,0,1,1,4,5,0,0,0,0,4,11
Idaho1,1,Chris Sarbaugh,SR,G,Idaho,Big Sky,33,837,68,134,67,128,1,6,53,75,37,109,146,104,31,6,74,72,190
Idaho2,2,Perrion Callandret,JR,G,Idaho,Big Sky,24,755,96,247,51,114,45,133,96,116,14,86,100,50,22,7,58,59,333
Idaho3,3,Chad Sherwood,SO,G,Idaho,Big Sky,33,749,79,202,13,44,66,158,24,29,9,43,52,58,14,1,45,60,248
Idaho4,4,Victor Sanders,SO,G,Idaho,Big Sky,26,736,121,284,52,125,69,159,109,130,18,74,92,44,33,16,52,74,420
Idaho5,5,Nate Sherwood,FR,F,Idaho,Big Sky,33,729,83,171,75,144,8,27,39,52,50,75,125,20,8,8,32,84,213
Idaho6,6,Arkadiy Mkrtychyan,SO,F,Idaho,Big Sky,30,547,77,163,77,160,0,3,58,97,36,77,113,22,16,2,45,77,212
Idaho7,7,Jordan Scott,SO,F,Idaho,Big Sky,33,541,42,110,37,87,5,23,14,32,39,70,109,30,6,11,29,58,103
Idaho8,8,Ty Egbert,JR,F,Idaho,Big Sky,26,469,61,111,61,111,0,0,54,80,32,73,105,10,9,22,27,46,176
Idaho9,9,Nahshon George,SR,F,Idaho,Big Sky,32,442,51,117,51,117,0,0,41,63,47,88,135,14,11,4,52,86,143
Idaho10,10,Patrick Ingram,JR,G,Idaho,Big Sky,24,318,30,67,30,66,0,1,28,43,5,32,37,36,12,3,41,40,88
Idaho11,11,Nick Blair,FR,F,Idaho,Big Sky,27,268,41,83,35,63,6,20,6,16,20,42,62,12,6,6,16,27,94
Idaho12,12,Jake Straughan,FR,G,Idaho,Big Sky,16,100,17,34,1,1,16,33,5,7,0,5,5,6,1,0,3,10,55
Idaho13,13,Paulin Mpawe,SR,F,Idaho,Big Sky,16,88,4,13,4,13,0,0,7,11,11,8,19,1,3,1,4,15,15
Idaho14,14,Skyler White,SO,F,Idaho,Big Sky,9,46,8,23,7,14,1,9,2,5,5,17,22,6,1,1,2,5,19
Idaho State1,1,Ethan Telfair,JR,G,Idaho State,Big Sky,31,1108,179,450,116,287,63,163,205,236,27,96,123,167,74,4,112,78,626
Idaho State2,2,Geno Luzcando,SO,G,Idaho State,Big Sky,31,950,151,300,114,197,37,103,107,150,31,95,126,41,61,3,84,91,446
Idaho State3,3,Ben Wilson,SR,G,Idaho State,Big Sky,29,921,78,156,78,156,0,0,43,68,34,140,174,64,19,6,42,60,199
Idaho State4,4,Kyle Ingram,JR,F,Idaho State,Big Sky,31,634,79,149,78,148,1,1,28,46,45,98,143,34,9,34,37,94,187
Idaho State5,5,Gary Chivichyan,FR,G,Idaho State,Big Sky,29,538,72,185,9,19,63,166,13,17,6,64,70,12,11,7,16,35,220
Idaho State6,6,Novak Topalovic,FR,C,Idaho State,Big Sky,31,428,34,75,34,75,0,0,22,43,44,82,126,8,10,23,20,74,90
Idaho State7,7,Ali Faruq-Bey,SO,G,Idaho State,Big Sky,17,402,73,183,41,85,32,98,44,61,9,30,39,15,20,2,41,26,222
Idaho State8,8,Erik Nakken,SO,G,Idaho State,Big Sky,28,362,28,76,3,4,25,72,2,4,1,27,28,3,3,1,10,20,83
Idaho State9,9,Stephen Lennox,FR,F,Idaho State,Big Sky,27,273,23,66,11,32,12,34,16,24,15,55,70,4,2,5,9,30,74
Idaho State10,10,Clint Nwosuh,JR,G,Idaho State,Big Sky,14,213,19,57,5,16,14,41,8,8,3,11,14,14,6,0,11,13,60
Idaho State11,11,Evann Hall,SR,G,Idaho State,Big Sky,17,165,16,32,16,32,0,0,10,21,7,32,39,6,4,2,7,17,42
Idaho State12,12,Justin Smith,SO,G,Idaho State,Big Sky,21,159,13,26,12,22,1,4,7,13,10,25,35,7,4,1,11,35,34
Idaho State13,13,Brandon Boyd,FR,G,Idaho State,Big Sky,5,32,3,10,1,6,2,4,4,5,1,3,4,3,3,0,2,9,12
Idaho State14,14,Spencer Nicolds,SO,F,Idaho State,Big Sky,3,15,1,2,1,1,0,1,0,4,0,3,3,2,0,2,0,5,2
Illinois1,1,Malcolm Hill,JR,G,Illinois,Big Ten,34,1195,192,440,155,322,37,118,193,235,43,180,223,112,42,15,75,88,614
Illinois2,2,Kendrick Nunn,JR,G,Illinois,Big Ten,28,982,155,362,80,170,75,192,50,63,10,129,139,48,41,5,45,63,435
Illinois3,3,Jalen Coleman-Lands,FR,G,Illinois,Big Ten,34,892,115,279,28,73,87,206,33,44,9,55,64,30,22,3,36,69,350
Illinois4,4,Khalid Lewis,SR,G,Illinois,Big Ten,32,741,47,127,41,103,6,24,26,37,7,46,53,96,29,4,40,52,126
Illinois5,5,Maverick Morgan,JR,C,Illinois,Big Ten,34,716,124,220,124,220,0,0,34,46,33,85,118,19,13,16,39,64,282
Illinois6,6,Michael Finke,FR,F,Illinois,Big Ten,33,671,90,207,50,98,40,109,28,43,45,76,121,32,4,5,31,60,248
Illinois7,7,Jaylon Tate,JR,G,Illinois,Big Ten,30,524,18,49,16,38,2,11,17,27,1,38,39,75,12,3,24,39,55
Illinois8,8,Aaron Jordan,FR,G,Illinois,Big Ten,30,350,31,95,9,31,22,64,19,23,5,23,28,14,12,3,7,47,103
Illinois9,9,D.J. Williams,FR,G,Illinois,Big Ten,29,319,24,60,22,48,2,12,11,19,16,25,41,10,7,4,22,27,61
Illinois10,10,Alex Austin,JR,G,Illinois,Big Ten,31,304,14,43,8,15,6,28,7,11,8,35,43,20,13,0,7,34,41
Illinois11,11,Mike Thorne,SR,F,Illinois,Big Ten,8,171,35,74,35,74,0,0,33,55,24,44,68,2,2,5,10,18,103
Illinois12,12,Leron Black,SO,F,Illinois,Big Ten,7,100,15,36,15,36,0,0,1,2,10,21,31,4,2,2,5,23,31
Illinois13,13,Cameron Liss,SO,F,Illinois,Big Ten,5,10,1,1,1,1,0,0,1,2,0,0,0,0,0,0,1,1,3
Illinois State1,1,Paris Lee,JR,G,Illinois State,MVC,32,972,114,289,78,176,36,113,91,117,9,77,86,117,54,3,61,65,355
Illinois State2,2,DeVaughn Akoon-Purcell,SR,G,Illinois State,MVC,32,895,157,364,138,291,19,73,118,165,51,107,158,60,30,13,86,62,451
Illinois State3,3,Tony Wills,JR,G,Illinois State,MVC,32,814,64,156,39,82,25,74,17,26,13,51,64,57,35,11,34,82,170
Illinois State4,4,Deontae Hawkins,SO,F,Illinois State,MVC,32,796,125,301,73,159,52,142,28,41,53,134,187,34,22,23,41,80,330
Illinois State5,5,MiKyle McIntosh,SO,F,Illinois State,MVC,31,745,114,263,81,176,33,87,78,117,59,89,148,56,20,18,69,110,339
Illinois State6,6,Nick Banyard,JR,F,Illinois State,MVC,32,636,61,154,37,84,24,70,19,42,34,105,139,19,16,10,41,64,165
Illinois State7,7,Justin McCloud,SR,G,Illinois State,MVC,32,546,44,123,7,12,37,111,2,4,5,50,55,25,11,1,11,43,127
Illinois State8,8,Quintin Brewer,SR,F,Illinois State,MVC,30,489,31,75,30,71,1,4,19,26,46,76,122,10,7,17,24,73,82
Illinois State9,9,Roland Griffin,FR,F,Illinois State,MVC,16,351,37,79,26,51,11,28,10,21,9,34,43,17,8,5,19,26,95
Illinois State10,10,Daouda Ndiaye,FR,C,Illinois State,MVC,12,106,7,16,7,16,0,0,7,21,7,19,26,2,0,14,4,13,21
Illinois State11,11,Keyshawn Evans,FR,G,Illinois State,MVC,10,65,3,13,3,9,0,4,3,6,1,4,5,4,2,0,4,1,9
Illinois State12,12,Javaka Thompson,JR,G,Illinois State,MVC,7,10,2,2,2,2,0,0,1,2,0,1,1,1,0,0,1,3,5
Illinois-Chicago1,1,Dikembe Dixson,FR,F,Illinois-Chicago,Horizon,30,1102,192,520,151,385,41,135,169,256,43,177,220,55,35,14,124,77,594
Illinois-Chicago2,2,Lance Whitaker,SO,F,Illinois-Chicago,Horizon,30,879,52,150,32,92,20,58,42,75,18,96,114,98,23,16,41,109,166
Illinois-Chicago3,3,Tai Odiase,SO,C,Illinois-Chicago,Horizon,30,835,114,228,114,227,0,1,57,120,95,98,193,6,15,97,35,82,285
Illinois-Chicago4,4,Najeal Young,JR,F,Illinois-Chicago,Horizon,27,622,67,150,67,147,0,3,35,57,50,120,170,23,21,4,41,50,169
Illinois-Chicago5,5,Michael Kolawole,FR,G,Illinois-Chicago,Horizon,30,563,58,164,46,115,12,49,44,68,16,61,77,36,17,0,42,39,172
Illinois-Chicago6,6,Paris Burns,SR,G,Illinois-Chicago,Horizon,16,394,41,113,30,72,11,41,18,25,5,23,28,40,15,2,37,41,111
Illinois-Chicago7,7,Jake Wiegand,SR,F,Illinois-Chicago,Horizon,27,365,43,91,43,86,0,5,39,57,38,49,87,9,8,0,31,62,125
Illinois-Chicago8,8,Gabe Snider,SR,G,Illinois-Chicago,Horizon,18,281,36,92,6,16,30,76,4,8,7,27,34,20,7,6,13,32,106
Illinois-Chicago9,9,Julian Torres,FR,C,Illinois-Chicago,Horizon,28,268,28,67,28,67,0,0,20,32,27,40,67,8,4,14,21,64,76
Illinois-Chicago10,10,Markese McGuire,JR,G,Illinois-Chicago,Horizon,27,234,17,60,12,41,5,19,20,30,10,20,30,15,7,6,17,18,59
Illinois-Chicago11,11,Dominique Matthews,FR,G,Illinois-Chicago,Horizon,9,204,30,88,21,62,9,26,18,31,6,19,25,19,3,0,18,26,87
Illinois-Chicago12,12,Drew Hackett,FR,G,Illinois-Chicago,Horizon,21,184,8,36,5,14,3,22,10,15,4,13,17,11,6,1,16,18,29
Illinois-Chicago13,13,Hassan Thomas,FR,F,Illinois-Chicago,Horizon,21,167,10,36,8,31,2,5,14,19,15,26,41,7,6,2,7,22,36
Illinois-Chicago14,14,Hans Christian Lauer,JR,F,Illinois-Chicago,Horizon,1,2,1,1,1,1,0,0,2,2,0,0,0,0,1,0,0,0,4
Incarnate Word1,1,Kyle Hittle,SR,F,Incarnate Word,Southland,29,970,158,328,86,157,72,171,82,112,33,138,171,67,34,3,44,73,470
Incarnate Word2,2,Mitchell Badillo,SR,G,Incarnate Word,Southland,29,916,99,207,65,128,34,79,53,71,25,80,105,138,51,0,67,70,285
Incarnate Word3,3,Derail Green,SO,F,Incarnate Word,Southland,29,794,115,256,95,206,20,50,70,85,34,91,125,58,15,9,55,70,320
Incarnate Word4,4,Shawn Johnson,SO,G,Incarnate Word,Southland,29,784,93,211,51,106,42,105,47,71,30,160,190,26,27,34,28,54,275
Incarnate Word5,5,Jontrell Walker,SO,G,Incarnate Word,Southland,28,650,103,268,55,125,48,143,98,105,10,35,45,53,27,2,64,49,352
Incarnate Word6,6,Sam Burmeister,SO,G,Incarnate Word,Southland,22,519,44,133,29,76,15,57,24,39,3,65,68,31,13,3,36,55,127
Incarnate Word7,7,Simi Socks,FR,F,Incarnate Word,Southland,29,436,45,101,44,94,1,7,59,69,23,50,73,10,11,16,28,86,150
Incarnate Word8,8,Tyler Singleton,FR,G,Incarnate Word,Southland,26,434,44,102,44,100,0,2,33,47,11,32,43,36,14,1,28,39,121
Incarnate Word9,9,Phillip Johnson,JR,G,Incarnate Word,Southland,26,129,4,16,2,9,2,7,4,6,2,7,9,5,0,1,3,9,14
Incarnate Word10,10,Jerred Kite,JR,F,Incarnate Word,Southland,22,126,6,14,6,14,0,0,4,11,7,10,17,4,6,5,8,18,16
Incarnate Word11,11,Tavin Askew,JR,F,Incarnate Word,Southland,12,67,7,17,7,16,0,1,1,4,5,7,12,0,2,1,1,15,15
Indiana1,1,Yogi Ferrell,SR,G,Indiana,Big Ten,32,1107,178,388,108,220,70,168,118,144,33,91,124,177,37,1,83,51,544
Indiana2,2,Troy Williams,JR,F,Indiana,Big Ten,32,827,149,285,128,221,21,64,99,146,48,142,190,64,37,28,82,66,418
Indiana3,3,Thomas Bryant,FR,C,Indiana,Big Ten,32,719,142,207,137,195,5,12,82,119,68,119,187,32,14,29,53,90,371
Indiana4,4,Robert Johnson,SO,G,Indiana,Big Ten,28,713,79,180,31,70,48,110,23,36,12,87,99,88,19,4,50,51,229
Indiana5,5,Collin Hartman,JR,F,Indiana,Big Ten,32,698,57,130,29,54,28,76,16,19,30,67,97,50,25,9,33,92,158
Indiana6,6,Nick Zeisloft,SR,G,Indiana,Big Ten,32,636,68,158,7,15,61,143,19,21,10,43,53,27,6,3,15,40,216
Indiana7,7,Max Bielfeldt,SR,F,Indiana,Big Ten,32,556,102,200,77,143,25,57,27,39,54,90,144,24,28,16,37,68,256
Indiana8,8,OG Anunoby,FR,F,Indiana,Big Ten,31,408,56,101,46,76,10,25,20,39,37,45,82,15,23,23,24,44,142
Indiana9,9,James Blackmon,SO,G,Indiana,Big Ten,13,319,73,152,36,72,37,80,23,27,17,37,54,22,16,5,25,19,206
Indiana10,10,Juwan Morgan,FR,F,Indiana,Big Ten,27,239,19,36,14,26,5,10,18,23,19,37,56,5,7,9,14,34,61
Indiana11,11,Harrison Niego,FR,G,Indiana,Big Ten,21,107,4,13,2,5,2,8,1,3,5,10,15,6,7,0,4,17,11
Indiana12,12,Ryan Burton,SR,F,Indiana,Big Ten,21,67,5,9,1,2,4,7,0,1,3,6,9,0,1,0,1,8,14
Indiana13,13,Tim Priller,SO,F,Indiana,Big Ten,12,16,1,3,1,1,0,2,2,2,3,2,5,0,2,0,1,2,4
Indiana14,14,Quentin Taylor,FR,G,Indiana,Big Ten,7,9,1,2,1,2,0,0,1,2,0,2,2,1,0,0,0,0,3
Indiana State1,1,Devonte Brown,SR,G,Indiana State,MVC,32,1051,138,371,116,276,22,95,197,260,32,123,155,88,31,9,110,77,495
Indiana State2,2,Brenton Scott,SO,G,Indiana State,MVC,32,978,158,392,82,194,76,198,74,96,20,111,131,42,39,7,57,55,466
Indiana State3,3,Khristian Smith,SR,F,Indiana State,MVC,32,934,111,300,87,205,24,95,75,105,33,134,167,61,37,7,52,102,321
Indiana State4,4,Everett Clemons,JR,G,Indiana State,MVC,32,828,60,135,59,128,1,7,51,84,47,153,200,89,33,1,45,63,172
Indiana State5,5,Matt Van Scyoc,JR,F,Indiana State,MVC,32,706,83,216,33,65,50,151,32,55,19,84,103,12,7,12,40,92,248
Indiana State6,6,Brandon Murphy,SO,C,Indiana State,MVC,32,531,55,116,55,116,0,0,45,71,64,70,134,2,5,5,34,88,155
Indiana State7,7,Niels Bunschoten,JR,F,Indiana State,MVC,32,462,48,116,28,45,20,71,26,31,14,36,50,13,7,18,21,82,142
Indiana State8,8,Emondre Rickman,FR,C,Indiana State,MVC,30,362,26,56,26,56,0,0,19,40,34,53,87,6,5,24,9,49,71
Indiana State9,9,Brandon Burnett,SR,G,Indiana State,MVC,30,294,18,58,11,26,7,32,6,12,10,30,40,11,11,1,25,39,49
Indiana State10,10,Laquarious Paige,SO,G,Indiana State,MVC,30,205,9,26,8,16,1,10,4,6,1,13,14,10,8,2,17,29,23
Indiana State11,11,Grant Prusator,JR,G,Indiana State,MVC,27,118,9,36,0,3,9,33,1,5,0,10,10,6,1,0,1,12,28
Iona1,1,Isaiah Williams,SR,G,Iona,MAAC,32,1052,147,341,63,103,84,238,36,52,69,155,224,61,26,16,45,88,414
Iona2,2,A.J. English,SR,G,Iona,MAAC,27,966,180,420,88,174,92,246,152,180,14,120,134,168,41,14,94,58,604
Iona3,3,Aaron Rountree,SR,F,Iona,MAAC,32,850,79,162,79,157,0,5,42,65,42,121,163,87,45,58,49,91,200
Iona4,4,Ibn Muhammad,SR,G,Iona,MAAC,32,838,57,134,20,43,37,91,16,24,10,50,60,86,32,0,31,61,167
Iona5,5,Deyshonee Much,SO,G,Iona,MAAC,29,829,125,259,48,88,77,171,54,67,20,83,103,50,34,5,48,62,381
Iona6,6,Jordan Washington,JR,F,Iona,MAAC,30,552,157,308,157,308,0,0,101,171,90,96,186,11,14,17,65,112,415
Iona7,7,Jahaad Proctor,FR,G,Iona,MAAC,31,484,61,133,44,73,17,60,24,34,15,49,64,34,14,2,21,31,163
Iona8,8,Rickey McGill,FR,G,Iona,MAAC,29,305,35,74,28,50,7,24,8,11,5,39,44,22,22,2,19,34,85
Iona9,9,Taylor Bessick,JR,F,Iona,MAAC,23,280,35,66,35,66,0,0,14,22,31,47,78,1,6,16,19,61,84
Iona10,10,Schadrac Casimir,SO,G,Iona,MAAC,4,97,9,24,4,12,5,12,2,2,0,7,7,11,4,0,3,3,25
Iona11,11,Ryden Hines,JR,F,Iona,MAAC,20,93,2,7,2,4,0,3,2,5,3,15,18,3,1,1,3,12,6
Iona12,12,Kelvin Amayo,SR,G,Iona,MAAC,4,39,1,10,0,9,1,1,0,0,1,5,6,4,2,1,5,5,3
Iowa1,1,Jarrod Uthoff,SR,F,Iowa,Big Ten,31,942,205,454,143,296,62,158,113,138,47,151,198,34,28,80,36,48,585
Iowa2,2,Mike Gesell,SR,G,Iowa,Big Ten,31,927,88,216,72,174,16,42,65,89,15,85,100,194,43,5,59,62,257
Iowa3,3,Anthony Clemmons,SR,G,Iowa,Big Ten,31,921,103,236,77,152,26,84,48,80,12,68,80,111,30,6,49,65,280
Iowa4,4,Peter Jok,JR,G,Iowa,Big Ten,30,815,162,370,87,188,75,182,88,102,25,74,99,46,40,1,45,71,487
Iowa5,5,Adam Woodbury,SR,C,Iowa,Big Ten,31,776,90,162,90,162,0,0,60,86,97,168,265,28,15,9,42,76,240
Iowa6,6,Dom Uhl,SO,F,Iowa,Big Ten,31,562,65,155,40,101,25,54,34,57,37,78,115,26,13,12,24,40,189
Iowa7,7,Nicholas Baer,FR,F,Iowa,Big Ten,31,443,53,108,28,47,25,61,10,15,33,46,79,16,21,19,16,44,141
Iowa8,8,Ahmad Wagner,FR,F,Iowa,Big Ten,30,300,30,45,30,44,0,1,19,35,31,46,77,6,9,12,11,48,79
Iowa9,9,Brady Ellingson,FR,G,Iowa,Big Ten,26,246,28,61,16,17,12,44,7,10,2,16,18,12,5,0,11,21,75
Iowa10,10,Christian Williams,FR,G,Iowa,Big Ten,18,89,7,25,6,21,1,4,7,9,9,6,15,6,4,0,4,6,22
Iowa11,11,Andrew Fleming,FR,G,Iowa,Big Ten,11,79,7,21,4,9,3,12,5,10,2,7,9,11,0,1,9,6,22
Iowa12,12,Dale Jones,JR,F,Iowa,Big Ten,6,78,12,30,3,10,9,20,0,0,2,16,18,3,1,2,4,11,33
Iowa13,13,Okey Ukah,SR,F,Iowa,Big Ten,7,20,4,7,4,7,0,0,0,2,1,1,2,0,2,1,0,5,8
Iowa14,14,Michael Soukup,JR,G,Iowa,Big Ten,5,14,1,4,0,1,1,3,0,1,0,1,1,2,0,0,0,0,3
Iowa State1,1,Monte Morris,JR,G,Iowa State,Big 12,32,1218,173,354,138,257,35,97,65,87,24,107,131,221,58,8,54,51,446
Iowa State2,2,Matt Thomas,JR,G,Iowa State,Big 12,32,1062,115,265,35,79,80,186,32,35,16,127,143,52,27,8,41,70,342
Iowa State3,3,Georges Niang,SR,F,Iowa State,Big 12,32,1053,250,457,202,331,48,126,84,105,45,153,198,107,28,21,83,103,632
Iowa State4,4,Abdel Nader,SR,F,Iowa State,Big 12,32,1000,150,316,103,185,47,131,73,98,26,137,163,50,33,22,76,86,420
Iowa State5,5,Jameel McKay,SR,F,Iowa State,Big 12,29,889,138,231,138,231,0,0,58,103,97,162,259,25,13,52,45,64,334
Iowa State6,6,Deonte Burton,JR,G,Iowa State,Big 12,23,440,91,171,75,137,16,34,33,55,34,61,95,27,19,15,27,57,231
Iowa State7,7,Hallice Cooke,SO,G,Iowa State,Big 12,29,321,28,69,10,19,18,50,7,11,2,27,29,27,10,4,17,33,81
Iowa State8,8,Nazareth Mitrou-Long,SR,G,Iowa State,Big 12,8,253,37,87,21,32,16,55,6,10,4,19,23,15,5,2,17,16,96
Iowa State9,9,Jordan Ashton,JR,G,Iowa State,Big 12,22,178,9,25,4,7,5,18,0,0,2,14,16,5,4,0,4,10,23
Iowa State10,10,Simeon Carter,FR,F,Iowa State,Big 12,12,39,5,10,5,10,0,0,0,3,2,4,6,0,0,2,1,5,10
Iowa State11,11,Brady Ernst,FR,F,Iowa State,Big 12,6,14,1,3,1,3,0,0,0,0,2,2,4,0,0,1,0,1,2
Iowa State12,12,Stuart Nezlek,JR,C,Iowa State,Big 12,5,8,1,2,1,2,0,0,0,0,0,1,1,0,0,0,3,0,2
Jackson State1,1,Raeford Worsham,SR,G,Jackson State,SWAC,34,1074,166,320,163,303,3,17,116,196,103,162,265,73,59,28,73,95,451
Jackson State2,2,Yettra Specks,JR,G,Jackson State,SWAC,35,1047,74,190,31,68,43,122,43,52,24,51,75,94,34,1,59,98,234
Jackson State3,3,Paris Collins,SO,G,Jackson State,SWAC,34,1033,162,441,110,253,52,188,65,105,48,161,209,61,64,22,65,83,441
Jackson State4,4,Chace Franklin,JR,G,Jackson State,SWAC,33,995,136,368,84,215,52,153,89,126,36,138,174,87,45,13,67,75,413
Jackson State5,5,Janarius Middleton,JR,F,Jackson State,SWAC,35,751,100,218,92,197,8,21,15,32,71,104,175,41,16,20,38,92,223
Jackson State6,6,Treshawn Bolden,JR,F,Jackson State,SWAC,33,539,46,117,46,116,0,1,21,43,38,80,118,28,5,19,50,100,113
Jackson State7,7,Kaven Bernard,SR,F,Jackson State,SWAC,35,522,86,183,74,147,12,36,36,52,39,79,118,16,12,8,31,71,220
Jackson State8,8,Javares Brent,JR,G,Jackson State,SWAC,35,509,55,183,6,24,49,159,8,10,8,46,54,28,12,4,16,34,167
Jackson State9,9,Troy Stancil,FR,G,Jackson State,SWAC,32,320,34,97,16,30,18,67,10,19,11,23,34,5,9,5,14,38,96
Jackson State10,10,Dontaveon Robinson,JR,G,Jackson State,SWAC,33,261,15,30,15,30,0,0,10,15,11,22,33,5,16,5,13,51,40
Jackson State11,11,Jonathan Thomas,SO,G,Jackson State,SWAC,11,20,1,1,1,1,0,0,0,0,0,0,0,0,0,0,0,6,2
Jacksonville1,1,Kori Babineaux,SR,G,Jacksonville,A-Sun,32,1149,257,549,248,516,9,33,71,113,22,133,155,123,31,5,90,75,594
Jacksonville2,2,Marcel White,JR,F,Jacksonville,A-Sun,32,1022,160,380,78,172,82,208,101,139,36,143,179,45,25,20,52,67,503
Jacksonville3,3,Darien Fernandez,JR,G,Jacksonville,A-Sun,32,741,59,179,27,80,32,99,28,44,20,88,108,86,54,1,46,90,178
Jacksonville4,4,J.R. Holder,JR,F,Jacksonville,A-Sun,32,740,99,219,80,159,19,60,100,142,44,78,122,42,29,9,52,66,317
Jacksonville5,5,Josh Adeyeye,SR,G,Jacksonville,A-Sun,31,635,94,217,36,73,58,144,37,50,18,104,122,21,9,3,28,36,283
Jacksonville6,6,Antwon Clayton,SO,F,Jacksonville,A-Sun,29,609,51,115,50,112,1,3,42,68,61,69,130,22,31,24,32,83,145
Jacksonville7,7,Darius Dawkins,JR,F,Jacksonville,A-Sun,19,555,87,186,17,46,70,140,20,25,10,60,70,9,4,8,20,50,264
Jacksonville8,8,Omar El Manasterly,JR,F,Jacksonville,A-Sun,31,363,25,54,25,54,0,0,24,35,34,62,96,9,8,2,12,58,74
Jacksonville9,9,Demontrez Austin,JR,F,Jacksonville,A-Sun,25,305,19,36,19,36,0,0,4,8,31,49,80,7,7,6,10,29,42
Jacksonville10,10,Cartree Pettis,JR,G,Jacksonville,A-Sun,25,206,5,11,4,10,1,1,5,10,1,17,18,28,7,7,13,25,16
Jacksonville11,11,Marcellous Bell,SR,G,Jacksonville,A-Sun,14,86,8,27,3,8,5,19,1,4,5,9,14,5,1,0,4,6,22
Jacksonville12,12,Shea Jones,JR,G,Jacksonville,A-Sun,8,33,2,9,1,2,1,7,1,2,2,7,9,5,1,0,1,7,6
Jacksonville State1,1,Jared Hamilton,FR,G,Jacksonville State,OVC,30,886,109,246,104,224,5,22,47,73,59,89,148,42,23,8,29,49,270
Jacksonville State2,2,JaQuail Townser,SR,G,Jacksonville State,OVC,30,878,95,242,49,128,46,114,48,65,19,95,114,107,35,3,54,71,284
Jacksonville State3,3,Malcolm Drumwright,SO,G,Jacksonville State,OVC,24,777,117,283,86,192,31,91,72,93,13,50,63,92,20,9,56,70,337
Jacksonville State4,4,Greg Tucker,JR,G,Jacksonville State,OVC,31,763,80,239,33,89,47,150,99,122,14,55,69,41,21,1,55,71,306
Jacksonville State5,5,Jeremy Watson,SR,F,Jacksonville State,OVC,29,730,68,173,56,133,12,40,77,102,54,115,169,13,11,8,43,66,225
Jacksonville State6,6,Erik Durham,JR,G,Jacksonville State,OVC,21,611,87,208,37,79,50,129,22,33,25,58,83,18,16,5,14,49,246
Jacksonville State7,7,Christian Cunningham,FR,F,Jacksonville State,OVC,25,478,48,86,48,86,0,0,24,40,48,62,110,8,8,45,15,75,120
Jacksonville State8,8,DelFincko Bogan,FR,G,Jacksonville State,OVC,30,391,43,120,19,52,24,68,9,12,9,30,39,33,16,1,27,33,119
Jacksonville State9,9,Andre Statam,FR,G,Jacksonville State,OVC,31,374,43,109,20,37,23,72,7,8,16,36,52,12,2,2,12,69,116
Jacksonville State10,10,Ed Jones,FR,F,Jacksonville State,OVC,14,153,18,42,18,41,0,1,8,10,6,12,18,2,1,11,5,20,44
Jacksonville State11,11,Ousmane Ba,JR,F,Jacksonville State,OVC,19,87,1,6,1,6,0,0,1,8,9,10,19,3,2,2,5,30,3
Jacksonville State12,12,Cam Biedscheid,JR,G,Jacksonville State,OVC,5,79,12,33,7,15,5,18,1,1,2,6,8,5,3,1,6,8,30
James Madison1,1,Ron Curry,SR,G,James Madison,CAA,31,1035,167,379,95,184,72,195,129,173,13,114,127,112,31,12,46,63,535
James Madison2,2,Jackson Kent,JR,G,James Madison,CAA,32,872,79,230,36,100,43,130,41,56,21,101,122,61,15,4,36,29,242
James Madison3,3,Tom Vodanovich,JR,F,James Madison,CAA,31,767,76,145,70,117,6,28,35,56,40,97,137,28,7,6,46,95,193
James Madison4,4,Shakir Brown,JR,G,James Madison,CAA,31,762,111,272,55,125,56,147,60,74,48,130,178,39,21,9,42,80,338
James Madison5,5,Yohanny Dalembert,JR,F,James Madison,CAA,30,638,115,212,115,212,0,0,50,103,65,138,203,23,10,39,68,83,280
James Madison6,6,Joey McLean,SO,G,James Madison,CAA,31,621,62,145,32,69,30,76,24,29,8,34,42,54,17,2,31,69,178
James Madison7,7,Winston Grays,SR,G,James Madison,CAA,32,526,52,126,22,46,30,80,41,53,18,61,79,33,10,5,19,42,175
James Madison8,8,Paulius Satkus,JR,F,James Madison,CAA,32,516,38,75,35,65,3,10,40,61,37,78,115,24,12,5,40,75,119
James Madison9,9,Dimitrije Cabarkapa,JR,F,James Madison,CAA,26,435,97,187,62,96,35,91,21,25,20,63,83,6,4,6,28,28,250
James Madison10,10,Devontae Morgan,JR,G,James Madison,CAA,22,173,16,31,15,27,1,4,11,31,6,17,23,19,8,4,7,23,44
James Madison11,11,Ivan Lukic,JR,F,James Madison,CAA,17,103,11,24,11,22,0,2,13,18,13,19,32,4,2,3,4,15,35
James Madison12,12,Kevin Kangni,FR,G,James Madison,CAA,13,58,3,19,2,8,1,11,2,3,3,4,7,3,2,2,3,7,9
James Madison13,13,Matt Risse,FR,G,James Madison,CAA,8,19,3,3,2,2,1,1,0,0,0,2,2,0,0,0,0,3,7
Kansas1,1,Frank Mason,JR,G,Kansas,Big 12,34,1131,141,317,100,218,41,99,122,167,26,123,149,159,45,2,63,71,445
Kansas2,2,Devonte' Graham,SO,G,Kansas,Big 12,34,1108,134,287,66,134,68,153,62,83,12,98,110,129,51,4,54,69,398
Kansas3,3,Perry Ellis,SR,F,Kansas,Big 12,34,1029,209,400,183,340,26,60,124,158,62,140,202,46,17,18,50,55,568
Kansas4,4,Wayne Selden,JR,G,Kansas,Big 12,34,1007,163,344,94,175,69,169,57,97,25,87,112,86,26,9,62,68,452
Kansas5,5,Landen Lucas,JR,F,Kansas,Big 12,32,552,57,94,57,93,0,1,51,79,72,128,200,14,15,21,34,82,165
Kansas6,6,Jamari Traylor,SR,F,Kansas,Big 12,33,460,40,71,40,71,0,0,27,40,35,73,108,18,20,28,37,79,107
Kansas7,7,Sviatoslav Mykhailiuk,SO,G,Kansas,Big 12,31,401,57,135,24,49,33,86,13,18,12,30,42,31,12,5,23,37,160
Kansas8,8,Brannen Greene,JR,G,Kansas,Big 12,28,351,44,81,13,19,31,62,42,50,4,57,61,21,6,1,28,30,161
Kansas9,9,Carlton Bragg Jr.,FR,F,Kansas,Big 12,34,309,61,105,57,98,4,7,12,18,31,50,81,15,13,7,27,57,138
Kansas10,10,Hunter Mickelson,SR,F,Kansas,Big 12,25,196,24,52,24,51,0,1,11,16,19,39,58,12,13,22,7,36,59
Kansas11,11,Cheick Diallo,FR,F,Kansas,Big 12,26,195,29,53,29,53,0,0,14,26,16,48,64,1,7,22,17,38,72
Kansas12,12,Lagerald Vick,FR,G,Kansas,Big 12,18,81,12,23,5,7,7,16,1,5,1,4,5,6,2,0,6,6,32
Kansas13,13,Evan Manning,SR,G,Kansas,Big 12,14,34,3,6,0,0,3,6,0,0,0,2,2,1,4,0,1,6,9
Kansas14,14,Tyler Self,JR,G,Kansas,Big 12,13,28,1,5,0,1,1,4,0,1,1,1,2,3,1,0,7,4,3
Kansas15,15,Clay Young,SO,F,Kansas,Big 12,8,18,1,1,1,1,0,0,2,4,0,3,3,0,0,0,1,2,4
Kansas State1,1,Wesley Iwundu,JR,F,Kansas State,Big 12,33,1070,140,293,134,263,6,30,108,155,39,111,150,123,44,8,95,78,394
Kansas State2,2,Justin Edwards,SR,G,Kansas State,Big 12,33,1042,145,328,107,211,38,117,90,130,81,115,196,92,58,16,72,72,418
Kansas State3,3,Dean Wade,FR,F,Kansas State,Big 12,33,871,111,256,85,167,26,89,80,122,67,101,168,37,20,17,31,88,328
Kansas State4,4,Barry Brown,FR,G,Kansas State,Big 12,33,852,100,287,55,153,45,134,40,64,23,69,92,50,40,3,50,65,285
Kansas State5,5,D.J. Johnson,JR,F,Kansas State,Big 12,32,651,107,176,107,176,0,0,82,122,84,82,166,9,23,29,52,85,296
Kansas State6,6,Stephen Hurt,SR,F,Kansas State,Big 12,33,632,74,182,58,129,16,53,47,63,32,114,146,22,16,12,50,81,211
Kansas State7,7,Kamau Stokes,FR,G,Kansas State,Big 12,21,563,62,170,27,67,35,103,39,54,13,45,58,57,20,0,44,49,198
Kansas State8,8,Carlbe Ervin II,JR,G,Kansas State,Big 12,33,504,36,94,31,66,5,28,26,34,25,39,64,49,16,1,31,44,103
Kansas State9,9,Austin Budke,JR,F,Kansas State,Big 12,33,430,21,55,19,44,2,11,33,44,21,46,67,13,8,3,20,70,77
Kansas State10,10,Brian Rohleder,SR,G,Kansas State,Big 12,23,62,4,10,4,9,0,1,2,6,3,4,7,4,3,1,2,22,10
Kansas State11,11,Ron Freeman,FR,G,Kansas State,Big 12,11,18,3,12,3,5,0,7,1,2,0,1,1,1,1,1,1,4,7
Kansas State12,12,Zach Winter,JR,G,Kansas State,Big 12,13,16,2,9,0,1,2,8,0,0,0,2,2,0,0,0,1,1,6
Kennesaw State1,1,Yonel Brown,SR,G,Kennesaw State,A-Sun,31,1203,198,478,119,261,79,217,103,130,22,83,105,76,35,0,79,61,578
Kennesaw State2,2,Kendrick Ray,JR,G,Kennesaw State,A-Sun,31,1059,214,441,173,327,41,114,110,154,44,130,174,85,44,7,76,95,579
Kennesaw State3,3,Nick Masterson,SO,G,Kennesaw State,A-Sun,31,696,55,154,24,65,31,89,5,10,13,40,53,37,17,8,33,54,146
Kennesaw State4,4,Aubrey Williams,JR,F,Kennesaw State,A-Sun,31,689,86,160,86,160,0,0,84,117,77,119,196,26,25,16,30,83,256
Kennesaw State5,5,Bernard Morena,JR,F,Kennesaw State,A-Sun,31,666,83,177,82,170,1,7,46,71,38,90,128,50,20,27,54,98,213
Kennesaw State6,6,Jordan Jones,SO,F,Kennesaw State,A-Sun,31,590,46,112,46,112,0,0,16,28,25,79,104,28,9,23,19,74,108
Kennesaw State7,7,Nigel Pruitt,SR,F,Kennesaw State,A-Sun,23,480,63,152,43,92,20,60,40,53,25,71,96,20,35,13,31,55,186
Kennesaw State8,8,Kyle Clarke,FR,G,Kennesaw State,A-Sun,26,411,40,86,39,83,1,3,27,43,12,30,42,30,18,3,45,43,108
Kennesaw State9,9,Tracy Hector,FR,F,Kennesaw State,A-Sun,18,302,10,27,10,25,0,2,7,16,11,23,34,21,11,1,20,27,27
Kennesaw State10,10,Kosta Jankovic,FR,F,Kennesaw State,A-Sun,16,109,14,29,10,18,4,11,0,2,2,13,15,5,1,1,5,12,32
Kennesaw State11,11,Josh Burnett,FR,G,Kennesaw State,A-Sun,8,17,2,8,0,3,2,5,0,1,1,1,2,0,1,0,1,3,6
Kent State1,1,Kellon Thomas,JR,G,Kent State,MAC,32,1007,122,327,77,184,45,143,106,146,10,58,68,82,20,1,47,76,395
Kent State2,2,Jimmy Hall,JR,F,Kent State,MAC,32,960,212,434,206,414,6,20,94,134,93,161,254,72,20,18,97,87,524
Kent State3,3,Chris Ortiz,SR,F,Kent State,MAC,32,807,81,188,65,136,16,52,70,104,49,127,176,24,15,14,44,77,248
Kent State4,4,Galal Cancer,SR,G,Kent State,MAC,32,777,61,157,24,55,37,102,33,52,29,61,90,47,31,2,37,68,192
Kent State5,5,Khaliq Spicer,SR,C,Kent State,MAC,32,718,92,150,92,150,0,0,56,90,74,124,198,17,10,51,24,70,240
Kent State6,6,Deon Edwin,JR,G,Kent State,MAC,32,537,70,141,46,76,24,65,29,44,34,64,98,21,28,1,28,45,193
Kent State7,7,Xavier Pollard,SR,G,Kent State,MAC,22,535,91,194,71,142,20,52,54,85,18,51,69,62,22,1,40,56,256
Kent State8,8,Jaylin Walker,FR,G,Kent State,MAC,22,420,53,143,23,53,30,90,34,43,19,25,44,17,13,0,23,26,170
Kent State9,9,Jalen Avery,FR,G,Kent State,MAC,28,239,9,37,6,18,3,19,3,5,2,12,14,27,9,1,12,16,24
Kent State10,10,Marvin Jones,JR,F,Kent State,MAC,27,238,17,51,13,32,4,19,11,14,17,33,50,4,0,7,6,28,49
Kent State11,11,Raasean Davis,SO,F,Kent State,MAC,25,203,25,46,25,46,0,0,16,23,25,27,52,0,1,10,19,29,66
Kent State12,12,Jon Fleming,JR,G,Kent State,MAC,4,9,1,3,1,1,0,2,2,4,1,0,1,0,1,0,0,0,4
Kentucky1,1,Tyler Ulis,SO,G,Kentucky,SEC,33,1219,178,412,126,260,52,152,161,188,19,85,104,236,48,4,62,58,569
Kentucky2,2,Jamal Murray,FR,G,Kentucky,SEC,34,1198,230,504,120,243,110,261,115,146,49,123,172,73,34,9,78,68,685
Kentucky3,3,Isaiah Briscoe,FR,G,Kentucky,SEC,32,1035,125,290,120,253,5,37,51,118,45,122,167,105,33,4,59,92,306
Kentucky4,4,Marcus Lee,JR,F,Kentucky,SEC,34,743,98,144,98,144,0,0,22,58,86,123,209,11,10,55,33,104,218
Kentucky5,5,Alex Poythress,SR,F,Kentucky,SEC,29,689,114,187,107,164,7,23,64,94,52,125,177,10,16,19,35,104,299
Kentucky6,6,Derek Willis,JR,F,Kentucky,SEC,30,562,78,163,27,46,51,117,32,35,29,89,118,11,19,22,21,53,239
Kentucky7,7,Skal Labissiere,FR,F,Kentucky,SEC,34,529,90,174,90,172,0,2,41,62,35,69,104,10,8,53,32,102,221
Kentucky8,8,Charles Matthews,FR,G,Kentucky,SEC,34,361,22,51,21,47,1,4,14,34,31,27,58,13,15,5,19,33,59
Kentucky9,9,Dominique Hawkins,JR,G,Kentucky,SEC,25,218,16,42,8,14,8,28,16,21,9,6,15,12,5,3,6,27,56
Kentucky10,10,Isaac Humphries,FR,F,Kentucky,SEC,22,208,16,40,16,40,0,0,11,15,20,36,56,2,2,16,10,46,43
Kentucky11,11,Mychal Mulder,JR,G,Kentucky,SEC,23,88,4,19,2,8,2,11,2,2,9,17,26,7,1,0,2,6,12
La Salle1,1,Jordan Price,JR,G,La Salle,A-10,31,1170,195,500,106,256,89,244,117,163,23,149,172,92,35,13,102,68,596
La Salle2,2,Cleon Roberts,JR,G,La Salle,A-10,31,1137,127,328,62,147,65,181,81,104,44,67,111,38,60,12,55,86,400
La Salle3,3,Johnnie Shuler,SO,G,La Salle,A-10,31,1104,93,279,30,88,63,191,49,62,19,97,116,92,40,0,68,75,298
La Salle4,4,Amar Stukes,SO,G,La Salle,A-10,31,954,62,202,42,137,20,65,37,56,11,59,70,100,40,3,42,86,181
La Salle5,5,Tony Washington,SO,F,La Salle,A-10,29,774,98,162,98,162,0,0,27,54,68,148,216,19,14,44,45,102,223
La Salle6,6,Rohan Brown,SR,G,La Salle,A-10,23,421,35,60,29,42,6,18,13,25,31,52,83,17,13,5,23,35,89
La Salle7,7,Karl Harris,FR,G,La Salle,A-10,25,268,24,74,12,32,12,42,6,13,6,28,34,8,3,4,9,30,66
La Salle8,8,Yevgen Sakhniuk,SO,F,La Salle,A-10,19,257,50,77,49,71,1,6,14,37,15,25,40,17,9,9,32,45,115
La Salle9,9,Dusan Majstorovic,FR,G,La Salle,A-10,15,85,4,15,2,2,2,13,2,2,1,12,13,4,1,2,3,8,12
La Salle10,10,O.J. Lewis,SR,G,La Salle,A-10,12,24,1,8,0,6,1,2,2,4,1,2,3,1,2,0,1,3,5
La Salle11,11,Hank Davis,JR,G,La Salle,A-10,3,6,1,2,1,2,0,0,0,0,0,0,0,0,0,0,0,1,2
Lafayette1,1,Nick Lindner,JR,G,Lafayette,Patriot,29,941,127,336,86,212,41,124,90,120,12,46,58,115,24,1,60,63,385
Lafayette2,2,Bryce Scott,SR,G,Lafayette,Patriot,28,887,120,259,47,92,73,167,37,50,13,71,84,63,26,5,33,50,350
Lafayette3,3,Matt Klinewski,SO,F,Lafayette,Patriot,30,779,151,304,150,301,1,3,99,130,47,101,148,39,11,14,53,85,402
Lafayette4,4,Monty Boykins,JR,G,Lafayette,Patriot,30,703,108,281,54,130,54,151,52,84,7,68,75,56,19,3,58,38,322
Lafayette5,5,Paulius Zalys,FR,F,Lafayette,Patriot,30,693,83,169,60,102,23,67,40,62,41,73,114,38,12,11,64,73,229
Lafayette6,6,Zach Rufer,SR,G,Lafayette,Patriot,28,664,63,161,15,35,48,126,19,30,20,79,99,49,33,3,29,60,193
Lafayette7,7,Ben Freeland,SR,F,Lafayette,Patriot,28,386,36,63,36,63,0,0,6,8,23,70,93,5,13,10,19,75,78
Lafayette8,8,Nathaniel Musters,SR,C,Lafayette,Patriot,30,337,20,42,20,42,0,0,4,6,15,61,76,13,7,7,19,40,44
Lafayette9,9,Auston Evans,FR,G,Lafayette,Patriot,27,306,30,57,30,52,0,5,20,38,8,27,35,12,13,7,23,40,80
Lafayette10,10,Eric Stafford,SO,G,Lafayette,Patriot,28,296,9,35,6,17,3,18,9,15,4,33,37,23,10,1,18,37,30
Lafayette11,11,Tyler Barlow,FR,F,Lafayette,Patriot,20,143,9,24,9,24,0,0,5,8,9,19,28,2,3,5,2,25,23
Lafayette12,12,Jacob Orender,FR,G,Lafayette,Patriot,12,25,1,6,0,0,1,6,0,0,0,1,1,1,0,0,4,2,3
Lafayette13,13,Billy Murphy,SR,F,Lafayette,Patriot,12,16,1,5,0,1,1,4,0,0,0,1,1,0,0,1,0,0,3
Lamar1,1,Nick Garth,FR,G,Lamar,Southland,29,734,123,323,57,127,66,196,78,96,22,59,81,75,26,1,53,58,390
Lamar2,2,Preston Mattingly,JR,G,Lamar,Southland,30,715,62,117,60,112,2,5,59,85,47,93,140,37,27,6,21,66,185
Lamar3,3,Marcus Owens,JR,G,Lamar,Southland,30,632,80,202,42,97,38,105,36,49,45,68,113,39,17,5,32,63,234
Lamar4,4,Kevin Booze,SO,G,Lamar,Southland,27,606,86,204,59,125,27,79,53,75,12,53,65,114,36,1,67,71,252
Lamar5,5,Lincoln Davis,JR,G,Lamar,Southland,30,587,53,146,40,94,13,52,79,123,19,62,81,46,26,8,41,53,198
Lamar6,6,Dorian Chatman,FR,F,Lamar,Southland,29,576,90,193,89,192,1,1,63,98,47,67,114,27,15,34,64,89,244
Lamar7,7,Josh Nzeakor,FR,F,Lamar,Southland,30,540,72,141,72,141,0,0,45,77,59,102,161,17,15,11,32,69,189
Lamar8,8,Dontavious Sears,SR,F,Lamar,Southland,29,418,77,175,55,91,22,84,29,45,40,94,134,18,19,15,23,38,205
Lamar9,9,Quan Jones,SR,G,Lamar,Southland,29,408,38,106,22,60,16,46,45,59,6,22,28,32,17,2,34,53,137
Lamar10,10,LeMon Gregory,SR,C,Lamar,Southland,29,324,42,80,42,80,0,0,21,37,23,49,72,5,9,11,29,59,105
Lamar11,11,Zjori Bosha,SO,G,Lamar,Southland,24,191,14,51,10,21,4,30,4,7,15,19,34,9,8,0,10,28,36
Lamar12,12,Boaz Williams,FR,F,Lamar,Southland,22,139,27,55,19,39,8,16,8,14,12,17,29,5,4,3,16,23,70
Lamar13,13,Christian Kennedy,JR,C,Lamar,Southland,16,85,4,17,4,16,0,1,1,8,8,8,16,0,2,16,5,18,9
Lamar14,14,Terrance Hubby,FR,F,Lamar,Southland,10,45,3,9,3,7,0,2,3,8,3,5,8,1,4,3,3,11,9
Lehigh1,1,Kahron Ross,SO,G,Lehigh,Patriot,32,1087,127,286,98,210,29,76,75,108,23,67,90,194,45,5,65,61,358
Lehigh2,2,Austin Price,JR,G,Lehigh,Patriot,32,1056,144,348,75,169,69,179,60,85,26,83,109,75,55,16,53,85,417
Lehigh3,3,Jesse Chuku,SR,F,Lehigh,Patriot,32,1001,108,250,53,114,55,136,35,43,47,128,175,42,20,41,35,76,306
Lehigh4,4,Kyle Leufroy,FR,G,Lehigh,Patriot,32,908,117,261,72,159,45,102,58,72,13,115,128,52,31,7,72,74,337
Lehigh5,5,Tim Kempton,JR,C,Lehigh,Patriot,29,864,182,328,177,312,5,16,145,192,69,207,276,41,20,13,84,90,514
Lehigh6,6,Devon Carter,SR,G,Lehigh,Patriot,32,486,40,101,25,56,15,45,11,16,18,32,50,27,17,2,20,24,106
Lehigh7,7,Justin Goldsborough,SR,F,Lehigh,Patriot,32,477,46,86,46,86,0,0,15,31,42,62,104,8,9,16,34,74,107
Lehigh8,8,Tyler Jenkins,SO,G,Lehigh,Patriot,32,275,23,56,11,24,12,32,5,8,5,14,19,25,12,0,29,43,63
Lehigh9,9,John Ross Glover,SR,F,Lehigh,Patriot,31,227,21,54,15,39,6,15,5,8,14,23,37,9,5,3,17,19,53
Lehigh10,10,Jay Jay Davis,SO,G,Lehigh,Patriot,11,19,2,7,1,4,1,3,2,2,1,0,1,4,0,0,0,2,7
Liberty1,1,Lovell Cabbil,FR,G,Liberty,Big South,32,982,100,264,49,119,51,145,62,73,11,93,104,80,45,10,75,84,313
Liberty2,2,Ryan Kemrite,SO,G,Liberty,Big South,32,915,90,203,33,63,57,140,27,42,31,96,127,30,21,3,28,96,264
Liberty3,3,Anthony Fields,SR,G,Liberty,Big South,32,768,63,141,51,107,12,34,28,39,8,28,36,91,15,0,56,57,166
Liberty4,4,A.C. Reid,SO,G,Liberty,Big South,32,745,85,236,25,59,60,177,18,25,7,84,91,47,20,4,49,71,248
Liberty5,5,Evan Maxwell,SO,C,Liberty,Big South,32,687,128,201,128,201,0,0,63,99,58,96,154,17,10,6,68,66,319
Liberty6,6,John Dawson,SO,G,Liberty,Big South,21,671,102,224,60,110,42,114,36,47,6,105,111,71,22,1,69,55,282
Liberty7,7,Caleb Homesley,FR,G,Liberty,Big South,32,640,85,178,55,94,30,84,32,48,18,92,110,42,27,14,36,93,232
Liberty8,8,Ezra Talbert,FR,F,Liberty,Big South,32,499,66,145,41,86,25,59,28,35,26,49,75,8,8,6,24,61,185
Liberty9,9,Ryan Hiepler,FR,G,Liberty,Big South,23,261,6,14,2,3,4,11,6,7,3,11,14,13,2,0,8,25,22
Liberty10,10,Hansel Atencia,FR,G,Liberty,Big South,19,165,8,27,7,21,1,6,11,19,3,12,15,17,4,0,10,22,28
Liberty11,11,Calvin Hoffman,SO,G,Liberty,Big South,7,39,1,3,0,0,1,3,0,0,1,3,4,3,0,0,4,1,3
Liberty12,12,Sam Worman,FR,G,Liberty,Big South,10,29,4,8,4,7,0,1,0,0,1,2,3,0,4,0,4,7,8
Lipscomb1,1,J.C. Hampton,JR,G,Lipscomb,A-Sun,33,1087,170,424,99,223,71,201,113,136,29,91,120,90,38,4,64,62,524
Lipscomb2,2,Nathan Moran,SO,G,Lipscomb,A-Sun,33,898,118,310,36,89,82,221,82,95,10,90,100,151,42,1,73,77,400
Lipscomb3,3,Eli Pepper,FR,F,Lipscomb,A-Sun,33,758,101,197,89,156,12,41,46,85,62,193,255,53,9,29,60,80,260
Lipscomb4,4,Cam Miller,JR,G,Lipscomb,A-Sun,33,753,70,128,57,98,13,30,31,49,22,53,75,63,41,8,26,55,184
Lipscomb5,5,Garrison Mathews,FR,G,Lipscomb,A-Sun,33,687,118,293,53,107,65,186,60,82,34,77,111,51,28,8,48,74,361
Lipscomb6,6,George Brammeier,SO,C,Lipscomb,A-Sun,33,574,92,161,92,161,0,0,56,92,59,77,136,23,5,15,40,90,240
Lipscomb7,7,Brett Wishon,JR,F,Lipscomb,A-Sun,33,566,70,180,26,50,44,130,30,37,19,79,98,45,5,11,41,45,214
Lipscomb8,8,Aaron Korn,SO,G,Lipscomb,A-Sun,27,336,30,66,22,42,8,24,3,9,9,53,62,12,8,1,14,21,71
Lipscomb9,9,Josh Williams,JR,G,Lipscomb,A-Sun,14,322,58,126,31,63,27,63,21,31,12,26,38,20,14,5,26,37,164
Lipscomb10,10,J.J. Butler,JR,G,Lipscomb,A-Sun,32,278,11,24,8,15,3,9,4,10,5,24,29,30,11,2,26,38,29
Lipscomb11,11,David Wishon,SR,C,Lipscomb,A-Sun,26,259,40,78,40,78,0,0,27,52,20,43,63,2,3,11,33,38,107
Lipscomb12,12,Asa Duvall,SO,G,Lipscomb,A-Sun,25,140,9,24,3,8,6,16,1,5,0,14,14,9,4,0,2,7,25
Lipscomb13,13,Charles Smith,JR,C,Lipscomb,A-Sun,10,39,1,6,1,6,0,0,9,12,2,1,3,0,0,3,1,4,11
Long Beach State1,1,Nick Faust,SR,G,Long Beach State,Big West,34,1050,197,448,115,226,82,222,107,158,48,159,207,75,49,16,79,87,583
Long Beach State2,2,Justin Bibbins,SO,G,Long Beach State,Big West,32,990,108,248,56,132,52,116,110,129,12,90,102,160,34,0,58,85,378
Long Beach State3,3,A.J. Spencer,SR,G,Long Beach State,Big West,34,861,106,248,74,165,32,83,23,35,16,82,98,49,13,2,33,77,267
Long Beach State4,4,Gabe Levin,SO,F,Long Beach State,Big West,31,813,107,213,101,185,6,28,81,121,67,116,183,46,28,26,59,91,301
Long Beach State5,5,Travis Hammonds,JR,G,Long Beach State,Big West,31,735,103,241,53,114,50,127,54,71,39,114,153,37,26,20,46,89,310
Long Beach State6,6,Noah Blackwell,FR,G,Long Beach State,Big West,32,650,63,179,20,61,43,118,14,20,15,45,60,71,11,2,28,56,183
Long Beach State7,7,Roschon Prince,SO,F,Long Beach State,Big West,34,630,69,161,69,161,0,0,76,118,44,78,122,18,18,7,31,97,214
Long Beach State8,8,Branford Jones,JR,G,Long Beach State,Big West,33,557,49,143,35,89,14,54,25,36,24,62,86,49,24,0,36,48,137
Long Beach State9,9,Mason Riggins,FR,F,Long Beach State,Big West,34,484,53,104,53,104,0,0,20,56,37,46,83,10,13,14,22,59,126
Long Beach State10,10,Anson Moye,JR,G,Long Beach State,Big West,15,74,3,10,3,4,0,6,0,2,2,4,6,1,2,0,4,3,6
Long Beach State11,11,Quentin Shropshire,SO,F,Long Beach State,Big West,7,13,1,4,1,4,0,0,0,0,1,2,3,0,1,0,1,2,2
Long Beach State12,12,Temidayo Yussuf,SO,F,Long Beach State,Big West,1,3,1,2,1,2,0,0,2,2,2,0,2,0,0,0,0,0,4
Long Island University1,1,Martin Hermannsson,SO,G,Long Island University,NEC,31,1124,154,336,118,236,36,100,157,178,25,109,134,146,55,8,68,65,501
Long Island University2,2,Jerome Frink,JR,F,Long Island University,NEC,31,1006,197,392,160,294,37,98,83,124,96,182,278,39,39,39,83,97,514
Long Island University3,3,Joel Hernandez,JR,G,Long Island University,NEC,31,941,142,315,121,239,21,76,74,117,55,133,188,35,27,8,47,72,379
Long Island University4,4,Aakim Saintil,JR,G,Long Island University,NEC,31,906,112,304,78,174,34,130,134,166,12,57,69,146,46,1,90,104,392
Long Island University5,5,Nura Zanna,SO,F,Long Island University,NEC,31,672,77,147,77,147,0,0,50,100,75,105,180,10,19,9,55,107,204
Long Island University6,6,Iverson Fleming,JR,G,Long Island University,NEC,27,539,48,132,33,80,15,52,20,31,9,31,40,33,22,3,25,38,131
Long Island University7,7,Trevin Woods,SO,G,Long Island University,NEC,30,498,39,126,16,35,23,91,13,19,30,64,94,10,18,12,20,66,114
Long Island University8,8,Glenn Feidanga,JR,F,Long Island University,NEC,30,266,23,52,23,51,0,1,21,35,24,32,56,3,4,2,11,62,67
Long Island University9,9,Trevon Woods,SO,G,Long Island University,NEC,14,168,13,50,4,14,9,36,1,5,10,13,23,3,4,2,8,27,36
Long Island University10,10,Raul Frias,FR,G,Long Island University,NEC,18,86,3,16,1,6,2,10,0,0,5,6,11,4,3,2,6,10,8
Long Island University11,11,Julius Van Sauers,FR,F,Long Island University,NEC,5,55,3,12,1,4,2,8,4,4,3,5,8,2,1,1,5,2,12
Long Island University12,12,Ganlandou Cisse,FR,G,Long Island University,NEC,7,12,2,2,2,2,0,0,0,0,0,1,1,0,0,0,0,2,4
Longwood1,1,Darrion Allen,JR,G,Longwood,Big South,33,1058,116,261,62,144,54,117,58,66,32,94,126,46,48,21,53,86,344
Longwood2,2,Lotanna Nwogbo,SR,C,Longwood,Big South,33,987,194,328,193,326,1,2,135,206,104,168,272,19,16,43,84,102,524
Longwood3,3,Kanayo Obi-Rapu,SO,G,Longwood,Big South,28,892,115,276,52,112,63,164,42,57,18,71,89,49,22,3,56,79,335
Longwood4,4,Tra'Vaughn White,SR,G,Longwood,Big South,26,855,116,327,74,189,42,138,74,87,15,59,74,66,26,0,39,62,348
Longwood5,5,Khris Lane,SO,F,Longwood,Big South,33,833,117,230,99,182,18,48,36,55,66,137,203,21,20,11,39,102,288
Longwood6,6,Shaquille Johnson,SR,F,Longwood,Big South,21,693,98,191,84,134,14,57,37,66,28,125,153,95,30,6,97,57,247
Longwood7,7,Bryan Gee,FR,G,Longwood,Big South,33,497,8,44,6,26,2,18,12,23,5,59,64,58,14,1,33,47,30
Longwood8,8,Leron Fisher,SR,G,Longwood,Big South,11,318,31,91,19,52,12,39,32,45,7,27,34,42,12,2,34,20,106
Longwood9,9,Chris Shields,FR,F,Longwood,Big South,14,294,37,78,27,49,10,29,8,10,10,27,37,19,5,2,15,39,92
Longwood10,10,Isaac Belton,JR,G,Longwood,Big South,24,191,21,60,10,24,11,36,14,19,6,21,27,5,10,1,11,25,67
Longwood11,11,Al Burge,FR,G,Longwood,Big South,14,32,7,13,7,11,0,2,2,2,5,3,8,1,2,1,2,5,16
Louisiana State1,1,Ben Simmons,FR,F,Louisiana State,SEC,33,1151,216,386,215,383,1,3,199,297,103,285,388,158,65,27,111,92,632
Louisiana State2,2,Antonio Blakeney,FR,G,Louisiana State,SEC,33,1016,137,322,85,167,52,155,89,119,26,88,114,31,22,5,25,48,415
Louisiana State3,3,Tim Quarterman,JR,G,Louisiana State,SEC,33,952,118,284,70,144,48,140,84,133,52,101,153,120,32,13,53,79,368
Louisiana State4,4,Craig Victor,SO,F,Louisiana State,SEC,25,673,108,238,107,232,1,6,70,114,54,85,139,20,25,16,30,97,287
Louisiana State5,5,Jalyn Patterson,SO,G,Louisiana State,SEC,28,617,46,122,16,32,30,90,10,17,10,28,38,44,34,1,21,39,132
Louisiana State6,6,Keith Hornsby,SR,G,Louisiana State,SEC,20,608,89,182,50,88,39,94,45,55,6,51,57,32,25,2,24,34,262
Louisiana State7,7,Josh Gray,SR,G,Louisiana State,SEC,32,496,70,159,62,121,8,38,26,40,8,58,66,58,31,1,46,54,174
Louisiana State8,8,Brandon Sampson,FR,G,Louisiana State,SEC,27,357,35,109,17,42,18,67,19,27,10,22,32,22,12,3,17,18,107
Louisiana State9,9,Aaron Epps,SO,F,Louisiana State,SEC,29,265,49,90,43,70,6,20,7,9,22,31,53,6,5,9,14,55,111
Louisiana State10,10,Elbert Robinson,SO,C,Louisiana State,SEC,23,213,22,43,22,43,0,0,11,26,20,27,47,7,2,6,19,46,55
Louisiana State11,11,Brian Bridgewater,JR,F,Louisiana State,SEC,19,152,16,34,16,34,0,0,9,17,12,19,31,4,6,6,11,18,41
Louisiana State12,12,Darcy Malone,JR,C,Louisiana State,SEC,19,138,8,19,8,13,0,6,0,2,7,18,25,4,2,1,14,29,16
Louisiana State13,13,Henry Shortess,JR,G,Louisiana State,SEC,7,7,1,1,1,1,0,0,0,0,0,1,1,0,1,0,0,0,2
Louisiana Tech1,1,Alex Hamilton,SR,G,Louisiana Tech,CUSA,32,1126,206,413,173,302,33,111,188,263,32,149,181,199,65,15,101,51,633
Louisiana Tech2,2,Erik McCree,JR,F,Louisiana Tech,CUSA,29,926,163,363,116,229,47,134,105,146,39,176,215,35,20,15,72,66,478
Louisiana Tech3,3,Dayon Griffin,SO,G,Louisiana Tech,CUSA,32,922,127,270,76,131,51,139,38,67,20,112,132,55,41,8,42,57,343
Louisiana Tech4,4,Jacobi Boykins,SO,G,Louisiana Tech,CUSA,30,857,99,235,49,98,50,137,35,50,17,75,92,26,23,15,28,70,283
Louisiana Tech5,5,Derric Jean,FR,G,Louisiana Tech,CUSA,32,679,84,188,57,119,27,69,41,59,29,68,97,69,31,8,47,74,236
Louisiana Tech6,6,Merrill Holden,JR,F,Louisiana Tech,CUSA,22,515,62,118,61,111,1,7,55,77,45,67,112,2,9,25,29,75,180
Louisiana Tech7,7,Branden Sheppard,FR,F,Louisiana Tech,CUSA,30,411,35,52,35,52,0,0,4,18,33,42,75,8,10,7,17,44,74
Louisiana Tech8,8,Jy'lan Washington,FR,F,Louisiana Tech,CUSA,31,372,30,75,26,51,4,24,23,46,24,49,73,7,14,28,19,43,87
Louisiana Tech9,9,LeAntwan Luckett,SR,G,Louisiana Tech,CUSA,28,306,33,99,27,60,6,39,18,34,15,19,34,13,8,3,16,47,90
Louisiana Tech10,10,Qiydar Davis,SR,G,Louisiana Tech,CUSA,7,164,24,55,22,50,2,5,24,28,18,29,47,10,8,6,6,19,74
Louisiana Tech11,11,Da'Shawn Robinson,JR,G,Louisiana Tech,CUSA,15,137,12,37,7,20,5,17,8,15,3,12,15,20,6,0,9,15,37
Louisiana Tech12,12,Joniah White,SO,C,Louisiana Tech,CUSA,4,89,9,17,9,17,0,0,1,4,13,6,19,2,1,8,2,12,19
Louisiana Tech13,13,Luke Walker,FR,G,Louisiana Tech,CUSA,11,21,2,7,2,7,0,0,3,5,1,4,5,1,2,0,1,5,7
Louisiana-Lafayette1,1,Shawn Long,SR,F,Louisiana-Lafayette,Sun Belt,31,963,220,418,202,353,18,65,147,219,127,259,386,44,23,55,85,84,605
Louisiana-Lafayette2,2,Jay Wright,JR,G,Louisiana-Lafayette,Sun Belt,30,847,88,239,57,146,31,93,54,87,16,69,85,107,30,8,73,67,261
Louisiana-Lafayette3,3,Johnathan Stove,SO,G,Louisiana-Lafayette,Sun Belt,31,805,92,208,78,168,14,40,80,108,41,64,105,52,8,6,40,88,278
Louisiana-Lafayette4,4,Bryce Washington,SO,F,Louisiana-Lafayette,Sun Belt,30,772,103,171,101,163,2,8,49,83,77,95,172,42,22,13,43,58,257
Louisiana-Lafayette5,5,Kasey Shepherd,SR,G,Louisiana-Lafayette,Sun Belt,31,679,101,256,49,103,52,153,74,84,15,49,64,51,40,2,46,46,328
Louisiana-Lafayette6,6,Steven Wronkoski,SR,G,Louisiana-Lafayette,Sun Belt,31,549,48,123,23,49,25,74,18,19,16,48,64,16,13,2,18,39,139
Louisiana-Lafayette7,7,Hayward Register,JR,G,Louisiana-Lafayette,Sun Belt,31,428,61,202,15,48,46,154,16,21,9,38,47,7,15,6,11,36,184
Louisiana-Lafayette8,8,Devonta Walker,SR,F,Louisiana-Lafayette,Sun Belt,31,392,54,95,54,93,0,2,49,69,52,70,122,10,12,10,35,60,157
Louisiana-Lafayette9,9,Jay Hedgeman,JR,F,Louisiana-Lafayette,Sun Belt,24,326,32,81,26,52,6,29,44,63,18,47,65,26,17,3,18,51,114
Louisiana-Lafayette10,10,Tiremone Williams,JR,G,Louisiana-Lafayette,Sun Belt,26,179,11,27,10,19,1,8,9,16,3,14,17,14,8,1,5,19,32
Louisiana-Lafayette11,11,Tyrone Wooten,JR,G,Louisiana-Lafayette,Sun Belt,22,168,22,52,19,36,3,16,16,26,7,27,34,16,6,3,16,19,63
Louisiana-Lafayette12,12,Scott Plaisance,FR,F,Louisiana-Lafayette,Sun Belt,17,54,9,15,9,14,0,1,12,17,7,7,14,1,2,5,2,12,30
Louisiana-Lafayette13,13,Elijah McGuire,SO,G,Louisiana-Lafayette,Sun Belt,14,51,4,13,3,6,1,7,1,5,2,9,11,3,2,0,1,9,10
Louisiana-Lafayette14,14,Matt Marlin,SR,G,Louisiana-Lafayette,Sun Belt,8,33,2,7,1,3,1,4,1,2,1,0,1,3,2,0,1,2,6
Louisiana-Monroe1,1,Nick Coppola,JR,G,Louisiana-Monroe,Sun Belt,33,1220,131,325,79,176,52,149,49,77,19,77,96,178,26,2,69,59,363
Louisiana-Monroe2,2,Justin Roberson,SR,G,Louisiana-Monroe,Sun Belt,33,1093,174,371,134,275,40,96,82,122,28,128,156,92,51,4,70,108,470
Louisiana-Monroe3,3,Majok Deng,SR,F,Louisiana-Monroe,Sun Belt,30,1092,188,394,129,238,59,156,124,153,48,163,211,58,22,50,65,75,559
Louisiana-Monroe4,4,Travis Munnings,FR,F,Louisiana-Monroe,Sun Belt,33,858,96,189,81,146,15,43,39,65,71,110,181,45,30,10,61,79,246
Louisiana-Monroe5,5,Jamaal Samuel,SR,F,Louisiana-Monroe,Sun Belt,33,847,128,290,89,188,39,102,18,27,40,113,153,19,11,23,38,73,313
Louisiana-Monroe6,6,DeMondre Harvey,SR,F,Louisiana-Monroe,Sun Belt,33,797,89,152,89,152,0,0,83,122,67,119,186,40,17,19,40,79,261
Louisiana-Monroe7,7,Mack Foster,SR,G,Louisiana-Monroe,Sun Belt,31,363,23,60,18,31,5,29,14,19,12,21,33,17,15,0,13,46,65
Louisiana-Monroe8,8,Marcus Washington,JR,G,Louisiana-Monroe,Sun Belt,20,199,19,50,14,30,5,20,17,26,4,21,25,14,6,2,10,32,60
Louisiana-Monroe9,9,Prince Cooper,JR,G,Louisiana-Monroe,Sun Belt,18,145,16,34,16,33,0,1,13,18,5,20,25,7,0,0,14,12,45
Louisiana-Monroe10,10,Roderick Taylor,FR,F,Louisiana-Monroe,Sun Belt,12,59,6,10,6,10,0,0,3,4,6,6,12,0,2,0,1,13,15
Louisiana-Monroe11,11,Wade Martin,FR,G,Louisiana-Monroe,Sun Belt,13,44,1,16,0,6,1,10,2,3,3,6,9,1,0,0,5,6,5
Louisiana-Monroe12,12,Lance Richard,SO,G,Louisiana-Monroe,Sun Belt,12,33,4,12,0,0,4,12,0,0,0,0,0,1,2,0,3,2,12
Louisville1,1,Damion Lee,SR,G,Louisville,ACC,30,1007,152,355,91,176,61,179,113,134,19,98,117,59,46,1,50,62,478
Louisville2,2,Quentin Snider,SO,G,Louisville,ACC,31,861,103,256,63,157,40,99,45,60,23,47,70,109,25,0,40,60,291
Louisville3,3,Trey Lewis,SR,G,Louisville,ACC,31,859,121,291,75,160,46,131,62,78,22,84,106,71,32,3,52,55,350
Louisville4,4,Chinanu Onuaku,SO,C,Louisville,ACC,31,762,137,221,137,220,0,1,33,56,91,172,263,51,24,62,65,92,307
Louisville5,5,Donovan Mitchell,FR,G,Louisville,ACC,31,591,84,190,66,118,18,72,43,57,34,70,104,52,25,3,30,78,229
Louisville6,6,Jaylen Johnson,SO,F,Louisville,ACC,31,541,70,151,68,141,2,10,14,26,50,59,109,14,10,10,17,61,156
Louisville7,7,Raymond Spalding,FR,F,Louisville,ACC,30,525,70,125,69,122,1,3,28,56,50,80,130,16,28,20,27,66,169
Louisville8,8,Anas Mahmoud,SO,F,Louisville,ACC,22,288,29,62,29,62,0,0,13,33,25,40,65,12,11,29,17,36,71
Louisville9,9,Deng Adel,FR,F,Louisville,ACC,22,267,31,68,24,48,7,20,20,27,10,36,46,14,6,1,26,23,89
Louisville10,10,Mangok Mathiang,JR,C,Louisville,ACC,10,188,27,48,27,48,0,0,17,29,26,31,57,5,7,12,11,22,71
Louisville11,11,Matz Stockman,SO,C,Louisville,ACC,23,142,26,47,26,47,0,0,10,21,20,19,39,4,1,8,7,27,62
Louisville12,12,David Levitch,JR,G,Louisville,ACC,18,127,13,20,5,8,8,12,8,11,4,8,12,9,5,0,5,10,42
Louisville13,13,Jay Henderson,FR,G,Louisville,ACC,10,23,1,7,0,3,1,4,0,0,0,2,2,2,2,0,1,2,3
Louisville14,14,Dillon Avare,SO,G,Louisville,ACC,7,19,2,6,0,1,2,5,0,0,0,0,0,1,0,0,2,3,6
Loyola (IL)1,1,Milton Doyle,JR,G,Loyola (IL),MVC,32,906,122,296,92,201,30,95,83,117,23,96,119,96,27,16,103,96,357
Loyola (IL)2,2,Earl Peterson,SR,G,Loyola (IL),MVC,31,848,93,212,74,169,19,43,66,88,9,68,77,67,26,7,52,43,271
Loyola (IL)3,3,Donte Ingram,SO,F,Loyola (IL),MVC,32,828,85,216,60,127,25,89,43,51,35,96,131,26,12,8,35,57,238
Loyola (IL)4,4,Devon Turk,SR,G,Loyola (IL),MVC,31,784,127,282,72,132,55,150,32,41,10,82,92,22,15,4,29,65,341
Loyola (IL)5,5,Montel James,SR,F,Loyola (IL),MVC,29,765,115,263,112,246,3,17,121,160,52,153,205,12,24,30,52,59,354
Loyola (IL)6,6,Ben Richardson,SO,G,Loyola (IL),MVC,31,739,48,127,12,46,36,81,14,16,5,54,59,52,32,5,26,71,146
Loyola (IL)7,7,Jeff White,SR,G,Loyola (IL),MVC,31,615,40,95,35,68,5,27,7,13,5,53,58,57,26,0,32,49,92
Loyola (IL)8,8,Tyson Smith,SO,G,Loyola (IL),MVC,25,424,35,104,15,48,20,56,28,38,5,26,31,24,13,4,17,44,118
Loyola (IL)9,9,Julius Rajala,SO,F,Loyola (IL),MVC,30,301,32,49,32,49,0,0,8,14,22,33,55,9,8,12,22,53,72
Loyola (IL)10,10,Maurice Kirby,SO,F,Loyola (IL),MVC,24,165,14,32,14,32,0,0,5,14,16,20,36,3,2,4,12,35,33
Loyola (IL)11,11,Pernell Adgei,FR,F,Loyola (IL),MVC,9,46,3,8,3,8,0,0,5,9,7,6,13,2,2,0,4,7,11
Loyola (IL)12,12,Cal Kennedy,SO,F,Loyola (IL),MVC,14,36,7,13,5,8,2,5,0,0,5,6,11,0,0,0,2,4,16
Loyola (IL)13,13,Glorind Lisha,FR,G,Loyola (IL),MVC,7,18,1,3,0,1,1,2,1,4,0,0,0,0,2,0,1,1,4
Loyola (MD)1,1,Andre Walker,SO,G,Loyola (MD),Patriot,30,972,129,346,83,227,46,119,122,152,17,85,102,117,45,6,77,87,426
Loyola (MD)2,2,Tyler Hubbard,SR,G,Loyola (MD),Patriot,30,885,88,267,26,75,62,192,46,64,8,41,49,35,9,0,29,58,284
Loyola (MD)3,3,Eric Laster,SR,G,Loyola (MD),Patriot,30,838,107,281,72,159,35,122,46,70,50,78,128,36,14,12,39,84,295
Loyola (MD)4,4,Franz Rassman,SR,F,Loyola (MD),Patriot,30,729,106,207,103,180,3,27,35,57,40,103,143,20,15,24,40,86,250
Loyola (MD)5,5,Jarred Jones,SR,F,Loyola (MD),Patriot,26,722,125,250,125,244,0,6,95,121,54,132,186,31,27,29,65,85,345
Loyola (MD)6,6,Chancellor Barnard,SO,F,Loyola (MD),Patriot,28,617,70,115,68,107,2,8,37,53,40,58,98,21,12,19,28,74,179
Loyola (MD)7,7,Cam Gregory,SO,F,Loyola (MD),Patriot,30,544,59,101,59,101,0,0,41,69,43,117,160,16,12,8,34,64,159
Loyola (MD)8,8,James Fives,FR,G,Loyola (MD),Patriot,28,309,12,50,9,29,3,21,25,40,15,27,42,7,11,1,15,55,52
Loyola (MD)9,9,Nevell Provo,FR,G,Loyola (MD),Patriot,26,219,12,28,8,11,4,17,0,1,2,9,11,22,7,1,16,19,28
Loyola (MD)10,10,Nick Gorski,JR,F,Loyola (MD),Patriot,24,138,12,30,12,29,0,1,11,15,10,12,22,5,1,2,9,17,35
Loyola (MD)11,11,Matt Staubi,SO,G,Loyola (MD),Patriot,19,129,9,17,3,7,6,10,5,7,1,5,6,25,5,0,16,11,29
Loyola (MD)12,12,Sean Tuohy,JR,G,Loyola (MD),Patriot,11,25,2,7,2,2,0,5,0,0,1,2,3,2,3,0,2,3,4
Loyola (MD)13,13,Josh Forney,JR,F,Loyola (MD),Patriot,6,16,1,1,1,1,0,0,2,4,0,1,1,0,0,0,0,2,4
Loyola Marymount1,1,Brandon Brown,JR,G,Loyola Marymount,WCC,31,983,144,381,122,303,22,78,81,107,27,47,74,177,44,1,79,52,391
Loyola Marymount2,2,Steven Haney,SO,F,Loyola Marymount,WCC,31,860,111,302,38,94,73,208,37,47,16,71,87,34,20,1,31,58,332
Loyola Marymount3,3,Adom Jacko,JR,F,Loyola Marymount,WCC,25,683,170,305,169,303,1,2,73,100,59,100,159,16,18,22,45,95,414
Loyola Marymount4,4,Marin Mornar,SR,F,Loyola Marymount,WCC,30,676,82,181,52,93,30,88,35,49,31,90,121,21,10,38,25,63,229
Loyola Marymount5,5,Shamar Johnson,JR,F,Loyola Marymount,WCC,31,648,65,135,65,135,0,0,41,62,58,73,131,30,20,5,45,100,171
Loyola Marymount6,6,Munis Tutu,FR,G,Loyola Marymount,WCC,31,565,36,121,26,81,10,40,40,52,14,44,58,94,26,3,35,65,122
Loyola Marymount7,7,David Humphries,SR,G,Loyola Marymount,WCC,29,528,47,126,13,33,34,93,17,22,22,75,97,27,16,1,18,41,145
Loyola Marymount8,8,Joshua Spiers,SO,F,Loyola Marymount,WCC,28,372,41,99,10,20,31,79,12,13,7,34,41,19,12,3,14,32,125
Loyola Marymount9,9,Petr Herman,SO,F,Loyola Marymount,WCC,30,342,45,94,45,94,0,0,20,32,32,51,83,16,16,12,24,50,110
Loyola Marymount10,10,Buay Tuach,JR,G,Loyola Marymount,WCC,26,324,32,92,15,40,17,52,14,21,12,30,42,24,14,4,10,31,95
Loyola Marymount11,11,Jeffery McClendon,FR,F,Loyola Marymount,WCC,26,263,18,47,14,37,4,10,16,27,29,29,58,19,13,0,12,36,56
Loyola Marymount12,12,Matt Hayes,JR,G,Loyola Marymount,WCC,14,86,5,20,0,1,5,19,3,4,0,2,2,5,2,0,3,8,18
Maine1,1,Aaron Calixte,SO,G,Maine,AEC,30,813,116,265,82,176,34,89,59,67,25,39,64,80,21,2,85,61,325
Maine2,2,Devine Eke,FR,F,Maine,AEC,29,695,122,196,122,194,0,2,39,103,65,130,195,22,21,47,36,64,283
Maine3,3,Kevin Little,SO,G,Maine,AEC,23,635,117,312,56,135,61,177,37,46,8,43,51,60,28,1,49,54,332
Maine4,4,Shaun Lawton,SR,G,Maine,AEC,24,594,67,158,47,109,20,49,51,70,18,74,92,51,45,3,52,70,205
Maine5,5,Troy Reid-Knight,JR,G,Maine,AEC,29,531,45,138,19,54,26,84,23,36,21,42,63,37,21,1,47,62,139
Maine6,6,Ilija Stojiljkovic,FR,F,Maine,AEC,28,507,38,97,22,48,16,49,9,19,29,74,103,45,25,7,47,89,101
Maine7,7,Issac Vann,FR,F,Maine,AEC,17,481,90,197,69,146,21,51,78,100,30,69,99,29,27,14,39,55,279
Maine8,8,Till Gloger,SR,F,Maine,AEC,29,463,112,200,112,200,0,0,36,57,35,43,78,2,9,3,29,38,260
Maine9,9,Ryan Bernstein,FR,G,Maine,AEC,24,432,36,97,23,55,13,42,6,15,16,29,45,47,16,2,35,35,91
Maine10,10,Lavar Harewood,FR,G,Maine,AEC,28,404,42,131,23,73,19,58,39,55,13,58,71,25,22,7,33,53,142
Maine11,11,Garet Beal,JR,G,Maine,AEC,11,220,18,49,7,9,11,40,12,15,2,17,19,13,3,1,21,29,59
Maine12,12,Marko Pirovic,JR,F,Maine,AEC,17,179,12,38,9,21,3,17,8,15,4,22,26,13,8,1,9,14,35
Maine13,13,Garvey Melmed,FR,G,Maine,AEC,14,43,3,10,0,0,3,10,1,2,1,3,4,1,0,0,2,9,10
Maine14,14,Walter King,FR,G,Maine,AEC,6,39,4,11,4,10,0,1,2,5,1,8,9,3,3,0,2,3,10
Maine15,15,Vincent Eze,FR,F,Maine,AEC,1,26,1,5,1,5,0,0,1,6,3,6,9,3,0,1,2,2,3
Maine16,16,C.J. Ward,SO,G,Maine,AEC,6,11,2,5,1,1,1,4,0,0,1,0,1,2,0,0,0,0,5
Manhattan1,1,Shane Richards,SR,F,Manhattan,MAAC,31,1125,154,398,76,183,78,215,146,170,19,99,118,52,29,3,63,77,532
Manhattan2,2,Tyler Wilson,JR,G,Manhattan,MAAC,31,885,29,83,25,73,4,10,60,101,12,50,62,161,45,1,80,101,122
Manhattan3,3,Rich Williams,JR,G,Manhattan,MAAC,31,879,166,367,128,262,38,105,90,113,45,140,185,41,33,15,74,82,460
Manhattan4,4,RaShawn Stores,SR,G,Manhattan,MAAC,28,826,68,172,24,67,44,105,42,63,16,47,63,85,40,0,48,76,222
Manhattan5,5,Thomas Capuano,FR,G,Manhattan,MAAC,31,824,59,150,30,70,29,80,11,20,11,41,52,58,43,0,33,64,158
Manhattan6,6,Zane Waterman,SO,F,Manhattan,MAAC,31,729,119,242,91,157,28,85,75,101,60,126,186,18,23,11,62,115,341
Manhattan7,7,Calvin Crawford,SO,F,Manhattan,MAAC,22,541,89,181,80,148,9,33,50,65,27,74,101,16,14,33,41,58,237
Manhattan8,8,Samson Akilo,SO,F,Manhattan,MAAC,28,221,11,21,11,21,0,0,4,6,7,17,24,3,3,4,11,38,26
Manhattan9,9,Carlton Allen,JR,C,Manhattan,MAAC,8,128,8,16,8,16,0,0,3,3,8,10,18,1,5,0,8,31,19
Manhattan10,10,Matt Maloney,FR,G,Manhattan,MAAC,19,81,3,12,1,2,2,10,2,4,1,5,6,0,2,1,4,18,10
Manhattan11,11,Ak Ojo,FR,C,Manhattan,MAAC,5,48,2,2,2,2,0,0,2,9,1,11,12,0,2,3,10,15,6
Marist1,1,Khallid Hart,JR,G,Marist,MAAC,28,1021,164,369,92,181,72,188,169,201,10,64,74,58,42,2,63,65,569
Marist2,2,Kristinn Palsson,FR,G,Marist,MAAC,30,950,84,222,17,33,67,189,16,28,11,118,129,35,21,7,33,86,251
Marist3,3,Brian Parker,FR,G,Marist,MAAC,29,913,163,317,153,291,10,26,126,174,46,104,150,84,20,1,90,63,462
Marist4,4,Isaiah Lamb,FR,G,Marist,MAAC,29,656,80,192,46,96,34,96,31,54,20,65,85,12,13,5,23,50,225
Marist5,5,Eric Truog,SR,C,Marist,MAAC,29,561,34,87,32,78,2,9,6,16,46,96,142,62,12,19,35,78,76
Marist6,6,Ryan Funk,FR,G,Marist,MAAC,25,448,52,144,25,49,27,95,21,26,21,33,54,9,8,1,13,45,152
Marist7,7,Kentrall Brooks,JR,F,Marist,MAAC,28,446,39,90,39,88,0,2,29,37,30,82,112,29,5,22,40,85,107
Marist8,8,David Knudsen,FR,G,Marist,MAAC,27,369,42,123,19,47,23,76,10,11,14,23,37,19,7,3,20,30,117
Marist9,9,K.J. Lee,SO,G,Marist,MAAC,28,332,25,62,18,45,7,17,12,15,8,35,43,23,4,5,18,25,69
Marist10,10,Phillip Lawrence-Ricks,SR,F,Marist,MAAC,20,170,22,49,17,32,5,17,8,14,12,21,33,7,2,2,7,15,57
Marist11,11,Connor McClenaghan,SO,C,Marist,MAAC,19,148,12,31,11,28,1,3,8,15,4,11,15,8,2,12,12,35,33
Marist12,12,Obi Momah,SO,F,Marist,MAAC,9,45,4,13,4,12,0,1,5,10,5,7,12,1,2,2,4,6,13
Marist13,13,Kyle Daugherty,FR,G,Marist,MAAC,12,16,2,7,2,2,0,5,5,5,0,1,1,1,0,0,1,4,9
Marquette1,1,Henry Ellenson,FR,F,Marquette,Big East,33,1107,194,435,164,331,30,104,143,191,71,250,321,59,28,49,78,84,561
Marquette2,2,Haanif Cheatham,FR,G,Marquette,Big East,33,974,131,268,102,193,29,75,100,122,13,98,111,73,35,1,89,67,391
Marquette3,3,Duane Wilson,SO,G,Marquette,Big East,33,939,131,307,77,151,54,156,68,104,10,75,85,84,43,6,67,76,384
Marquette4,4,Luke Fischer,JR,C,Marquette,Big East,33,932,158,260,158,260,0,0,83,122,100,103,203,32,14,47,58,97,399
Marquette5,5,Traci Carter,FR,G,Marquette,Big East,33,790,54,157,32,87,22,70,48,65,14,68,82,153,47,5,77,99,178
Marquette6,6,JaJuan Johnson,JR,G,Marquette,Big East,32,757,123,241,98,176,25,65,55,69,24,79,103,63,51,8,49,48,326
Marquette7,7,Sandy Cohen,SO,F,Marquette,Big East,32,745,61,139,34,63,27,76,40,54,9,94,103,57,24,14,35,83,189
Marquette8,8,Wally Ellenson,JR,G,Marquette,Big East,29,254,20,51,15,31,5,20,10,18,19,46,65,10,10,4,8,39,55
Marquette9,9,Matt Heldt,FR,C,Marquette,Big East,20,101,4,10,4,10,0,0,5,9,6,11,17,1,2,3,8,18,13
Marquette10,10,Sacar Anim,FR,F,Marquette,Big East,17,83,8,17,6,12,2,5,1,6,5,2,7,1,4,0,5,9,19
Marshall1,1,Stevie Browning,JR,G,Marshall,CUSA,33,1076,165,361,119,225,46,136,46,62,40,108,148,118,35,12,82,69,422
Marshall2,2,James Kelly,SR,F,Marshall,CUSA,33,1009,260,479,211,320,49,159,94,126,61,263,324,38,44,36,77,94,663
Marshall3,3,Austin Loop,JR,G,Marshall,CUSA,33,955,97,238,11,22,86,216,31,36,19,37,56,34,24,8,14,55,311
Marshall4,4,Ryan Taylor,JR,F,Marshall,CUSA,33,882,168,303,146,236,22,67,112,173,66,152,218,99,35,25,80,124,470
Marshall5,5,Jon Elmore,SO,G,Marshall,CUSA,25,866,111,295,50,118,61,177,98,122,19,66,85,145,19,3,64,64,381
Marshall6,6,C.J. Burks,SO,G,Marshall,CUSA,33,742,111,232,77,127,34,105,34,48,16,50,66,61,32,2,37,52,290
Marshall7,7,Terrence Thompson,SO,F,Marshall,CUSA,32,360,38,78,36,72,2,6,31,57,40,73,113,11,14,5,18,54,109
Marshall8,8,Justin Edmonds,SR,G,Marshall,CUSA,27,236,25,77,6,17,19,60,8,21,5,19,24,22,7,0,24,28,77
Marshall9,9,Aleksandar Dozic,FR,F,Marshall,CUSA,23,199,14,37,10,22,4,15,0,5,5,28,33,12,5,2,7,30,32
Marshall10,10,Ajdin Penava,FR,F,Marshall,CUSA,18,109,12,31,10,17,2,14,9,13,4,14,18,5,1,8,7,35,35
Marshall11,11,Noah Frampton,FR,G,Marshall,CUSA,6,64,2,11,1,2,1,9,0,0,4,3,7,3,6,0,2,6,5
Marshall12,12,Jacob Kilgore,FR,F,Marshall,CUSA,14,55,6,14,1,2,5,12,1,2,3,3,6,1,3,1,0,5,18
Marshall13,13,Milan Mijovic,SO,F,Marshall,CUSA,13,52,5,11,5,11,0,0,7,14,7,9,16,3,0,1,3,12,17
Marshall14,14,Brett Bowling,SO,G,Marshall,CUSA,10,23,3,10,2,2,1,8,0,0,1,1,2,1,0,0,2,3,7
Maryland1,1,Melo Trimble,SO,G,Maryland,Big Ten,33,1081,144,348,88,180,56,168,130,151,11,106,117,168,44,6,89,58,474
Maryland2,2,Rasheed Sulaimon,SR,G,Maryland,Big Ten,33,1071,125,268,70,146,55,122,61,83,9,107,116,117,35,3,61,46,366
Maryland3,3,Jake Layman,SR,F,Maryland,Big Ten,33,1005,126,253,74,125,52,128,67,83,37,138,175,38,37,31,60,68,371
Maryland4,4,Robert Carter,JR,F,Maryland,Big Ten,33,871,161,287,136,214,25,73,74,100,56,168,224,63,27,44,71,90,421
Maryland5,5,Diamond Stone,FR,C,Maryland,Big Ten,32,739,158,279,158,279,0,0,97,128,74,103,177,13,17,51,47,68,413
Maryland6,6,Jared Nickens,SO,G,Maryland,Big Ten,33,645,60,162,13,27,47,135,8,11,11,54,65,17,10,7,16,45,175
Maryland7,7,Damonte Dodd,JR,F,Maryland,Big Ten,33,512,38,62,38,62,0,0,24,35,34,59,93,9,3,23,30,80,100
Maryland8,8,Michal Cekovsky,SO,F,Maryland,Big Ten,28,244,24,43,24,42,0,1,19,35,15,39,54,4,6,11,16,43,67
Maryland9,9,Jaylen Brantley,SO,G,Maryland,Big Ten,29,240,27,56,15,29,12,27,8,12,4,25,29,18,7,1,9,21,74
Maryland10,10,Varun Ram,SR,G,Maryland,Big Ten,25,119,4,20,1,6,3,14,11,15,2,7,9,7,6,0,7,22,22
Maryland11,11,Ivan Bender,FR,F,Maryland,Big Ten,10,43,7,9,7,9,0,0,4,9,3,14,17,3,1,0,4,5,18
Maryland12,12,Trevor Anzmann,SR,G,Maryland,Big Ten,10,24,1,3,0,0,1,3,0,0,0,0,0,2,0,0,2,1,3
Maryland13,13,Andrew Terrell,FR,G,Maryland,Big Ten,8,14,1,2,0,0,1,2,0,0,0,1,1,1,0,0,0,0,3
Maryland-Baltimore County1,1,Joe Sherburne,FR,G,Maryland-Baltimore County,AEC,32,1026,120,283,59,108,61,175,35,44,31,113,144,34,37,5,33,74,336
Maryland-Baltimore County2,2,Will Darley,JR,G,Maryland-Baltimore County,AEC,30,886,129,262,80,149,49,113,49,58,17,112,129,57,18,9,56,48,356
Maryland-Baltimore County3,3,Rodney Elliott,SO,G,Maryland-Baltimore County,AEC,28,834,104,259,68,138,36,121,114,140,23,65,88,100,24,2,75,91,358
Maryland-Baltimore County4,4,Jourdan Grant,SO,G,Maryland-Baltimore County,AEC,32,779,74,159,70,142,4,17,81,139,12,84,96,76,41,4,67,85,233
Maryland-Baltimore County5,5,Jairus Lyles,SO,G,Maryland-Baltimore County,AEC,21,761,170,360,132,249,38,111,104,149,27,89,116,59,53,0,62,59,482
Maryland-Baltimore County6,6,Cody Joyce,SR,F,Maryland-Baltimore County,AEC,29,606,84,172,84,171,0,1,61,87,33,78,111,13,10,5,38,76,229
Maryland-Baltimore County7,7,Joel Wincowski,FR,G,Maryland-Baltimore County,AEC,26,271,9,39,4,14,5,25,2,2,13,17,30,7,7,2,5,18,25
Maryland-Baltimore County8,8,Sam Schwietz,FR,F,Maryland-Baltimore County,AEC,27,248,18,34,18,34,0,0,8,26,22,21,43,3,8,15,12,58,44
Maryland-Baltimore County9,9,Nolan Gerrity,FR,F,Maryland-Baltimore County,AEC,19,220,23,43,23,43,0,0,14,33,21,21,42,2,1,11,5,38,60
Maryland-Baltimore County10,10,Daquon Ervin,FR,G,Maryland-Baltimore County,AEC,14,218,7,39,6,26,1,13,11,20,3,17,20,17,8,0,7,19,26
Maryland-Baltimore County11,11,Malcolm Brent,SO,G,Maryland-Baltimore County,AEC,20,210,15,61,8,18,7,43,9,15,4,25,29,6,6,1,7,20,46
Maryland-Baltimore County12,12,Ben Grace,JR,G,Maryland-Baltimore County,AEC,23,165,13,29,1,3,12,26,5,6,1,12,13,12,4,0,7,18,43
Maryland-Baltimore County13,13,Ishmail Jabbie,FR,G,Maryland-Baltimore County,AEC,19,143,16,34,13,27,3,7,17,23,6,9,15,7,6,0,8,17,52
Maryland-Baltimore County14,14,Jakob Stenhede,SO,F,Maryland-Baltimore County,AEC,14,83,6,14,6,14,0,0,5,12,5,12,17,0,0,3,3,15,17
Maryland-Eastern Shore1,1,Devin Martin,SR,G,Maryland-Eastern Shore,MEAC,30,987,174,410,107,224,67,186,90,119,31,108,139,63,38,10,72,64,505
Maryland-Eastern Shore2,2,Dominique Elliott,SR,F,Maryland-Eastern Shore,MEAC,32,987,180,331,175,314,5,17,108,169,76,179,255,49,18,16,94,101,473
Maryland-Eastern Shore3,3,Bakari Copeland,JR,F,Maryland-Eastern Shore,MEAC,32,814,101,234,83,168,18,66,115,153,21,125,146,45,8,5,63,88,335
Maryland-Eastern Shore4,4,Ryan Andino,SO,G,Maryland-Eastern Shore,MEAC,31,677,64,179,8,20,56,159,6,10,7,29,36,32,13,0,32,35,190
Maryland-Eastern Shore5,5,Thomas Rivera,JR,G,Maryland-Eastern Shore,MEAC,29,636,45,127,34,80,11,47,32,48,13,41,54,99,29,2,70,64,133
Maryland-Eastern Shore6,6,Derrico Peck,SR,G,Maryland-Eastern Shore,MEAC,32,489,56,74,56,74,0,0,9,19,37,53,90,28,22,21,25,66,121
Maryland-Eastern Shore7,7,Dontae Caldwell,FR,G,Maryland-Eastern Shore,MEAC,32,424,51,125,27,56,24,69,36,44,20,33,53,15,16,6,38,42,162
Maryland-Eastern Shore8,8,Ahmad Frost,FR,G,Maryland-Eastern Shore,MEAC,20,353,19,47,7,17,12,30,12,15,4,25,29,36,7,1,19,40,62
Maryland-Eastern Shore9,9,Mark Blackmon,JR,G,Maryland-Eastern Shore,MEAC,32,301,13,39,7,22,6,17,10,15,11,18,29,16,20,0,15,40,42
Maryland-Eastern Shore10,10,Shane Randall,JR,F,Maryland-Eastern Shore,MEAC,27,294,21,42,19,34,2,8,20,23,13,28,41,8,6,2,23,71,64
Maryland-Eastern Shore11,11,Isaac Taylor,FR,F,Maryland-Eastern Shore,MEAC,31,176,17,48,17,48,0,0,8,12,20,21,41,1,0,5,15,39,42
Maryland-Eastern Shore12,12,Marc Seylan,JR,G,Maryland-Eastern Shore,MEAC,15,141,6,22,6,15,0,7,2,3,5,12,17,9,6,0,15,10,14
Maryland-Eastern Shore13,13,Joshu'a Warren,JR,F,Maryland-Eastern Shore,MEAC,10,93,7,17,7,17,0,0,4,8,11,5,16,0,4,4,12,19,18
Maryland-Eastern Shore14,14,Stephen Spurlock,SO,G,Maryland-Eastern Shore,MEAC,14,70,4,17,4,15,0,2,2,4,5,9,14,1,1,0,3,8,10
Maryland-Eastern Shore15,15,Maurice Coleman,FR,G,Maryland-Eastern Shore,MEAC,10,33,1,3,1,1,0,2,5,6,1,1,2,1,0,0,2,4,7
Massachusetts1,1,Trey Davis,SR,G,Massachusetts,A-10,32,1087,184,470,101,243,83,227,148,169,20,127,147,103,38,4,91,64,599
Massachusetts2,2,Donte Clark,SO,G,Massachusetts,A-10,32,995,158,384,96,201,62,183,139,184,19,103,122,73,28,9,71,105,517
Massachusetts3,3,Jabarie Hinds,SR,G,Massachusetts,A-10,32,947,175,382,127,252,48,130,64,87,14,61,75,96,47,7,54,67,462
Massachusetts4,4,C.J. Anderson,SO,G,Massachusetts,A-10,32,774,38,102,29,67,9,35,27,36,18,111,129,67,25,3,37,54,112
Massachusetts5,5,Seth Berger,SO,F,Massachusetts,A-10,31,604,63,125,49,82,14,43,22,38,28,75,103,15,18,9,23,83,162
Massachusetts6,6,Tyler Bergantino,SR,C,Massachusetts,A-10,29,541,35,53,35,53,0,0,7,15,35,65,100,9,9,26,9,59,77
Massachusetts7,7,Antwan Space,SR,F,Massachusetts,A-10,22,537,55,149,46,109,9,40,20,45,31,86,117,38,15,18,41,68,139
Massachusetts8,8,Zach Coleman,SO,F,Massachusetts,A-10,27,480,34,106,25,59,9,47,30,54,36,84,120,31,18,8,21,54,107
Massachusetts9,9,Rashaan Holloway,FR,C,Massachusetts,A-10,30,350,66,111,66,111,0,0,23,58,42,50,92,7,6,18,34,81,155
Massachusetts10,10,Malik Hines,FR,F,Massachusetts,A-10,16,158,6,13,6,13,0,0,5,8,10,28,38,3,3,10,14,28,17
Massachusetts11,11,Zach Turcotte,JR,F,Massachusetts,A-10,7,13,2,5,2,3,0,2,0,0,0,3,3,1,0,1,2,2,4
Massachusetts12,12,Rayshawn Miller,FR,G,Massachusetts,A-10,7,11,1,3,1,1,0,2,0,0,0,1,1,0,0,0,1,2,2
Massachusetts-Lowell1,1,Isaac White,FR,G,Massachusetts-Lowell,AEC,29,912,99,227,29,63,70,164,66,83,7,75,82,70,27,3,63,61,334
Massachusetts-Lowell2,2,Jahad Thomas,SO,F,Massachusetts-Lowell,AEC,29,863,177,302,176,298,1,4,58,115,54,160,214,100,37,6,109,89,413
Massachusetts-Lowell3,3,Josh Gantz,FR,F,Massachusetts-Lowell,AEC,29,672,66,162,47,98,19,64,22,40,34,62,96,47,16,28,38,82,173
Massachusetts-Lowell4,4,Matt Harris,SO,G,Massachusetts-Lowell,AEC,28,612,93,206,42,85,51,121,45,51,11,53,64,35,20,1,39,59,282
Massachusetts-Lowell5,5,Ryan Jones,FR,G,Massachusetts-Lowell,AEC,29,584,66,173,37,84,29,89,39,55,11,32,43,28,17,2,41,45,200
Massachusetts-Lowell6,6,Mark Cornelius,SR,G,Massachusetts-Lowell,AEC,29,546,72,127,59,99,13,28,27,46,30,82,112,47,28,1,43,57,184
Massachusetts-Lowell7,7,Tyler Livingston,JR,F,Massachusetts-Lowell,AEC,25,467,74,168,51,85,23,83,15,19,23,53,76,21,11,5,25,54,186
Massachusetts-Lowell8,8,Logan Primerano,FR,F,Massachusetts-Lowell,AEC,28,456,59,129,47,93,12,36,49,63,14,46,60,31,17,7,33,55,179
Massachusetts-Lowell9,9,Keith Hayes II,FR,G,Massachusetts-Lowell,AEC,23,320,41,92,27,54,14,38,44,54,8,25,33,16,14,1,16,29,140
Massachusetts-Lowell10,10,Dontavious Smith,FR,F,Massachusetts-Lowell,AEC,24,273,38,75,38,74,0,1,9,18,24,54,78,20,14,17,34,43,85
Massachusetts-Lowell11,11,DJ Mlachnik,SR,G,Massachusetts-Lowell,AEC,16,109,14,37,6,10,8,27,6,10,0,8,8,4,1,0,4,17,42
Massachusetts-Lowell12,12,Jordan Shea,FR,G,Massachusetts-Lowell,AEC,8,36,1,7,1,3,0,4,1,2,1,2,3,7,3,0,2,5,3
McNeese State1,1,Jamaya Burr,JR,G,McNeese State,Southland,29,1048,127,309,93,216,34,93,159,207,23,85,108,104,44,1,98,64,447
McNeese State2,2,Jarren Greenwood,FR,G,McNeese State,Southland,28,859,102,263,60,140,42,123,57,84,10,51,61,48,32,1,34,51,303
McNeese State3,3,Craig McFerrin,SR,F,McNeese State,Southland,29,760,110,209,110,205,0,4,46,71,67,161,228,29,15,23,56,82,266
McNeese State4,4,James Harvey,FR,G,McNeese State,Southland,29,701,95,267,35,87,60,180,59,76,11,30,41,24,17,2,27,49,309
McNeese State5,5,Lance Potier,JR,G,McNeese State,Southland,28,595,47,137,27,70,20,67,10,20,23,73,96,30,15,25,23,61,124
McNeese State6,6,Tevin Jackson,JR,G,McNeese State,Southland,29,512,67,163,56,126,11,37,20,31,24,74,98,45,16,6,43,56,165
McNeese State7,7,Austin Lewis,SR,F,McNeese State,Southland,28,405,48,91,48,91,0,0,20,34,52,77,129,4,9,36,21,70,116
McNeese State8,8,Stephen Ugochukwu,SO,F,McNeese State,Southland,27,390,56,126,51,113,5,13,42,66,41,59,100,12,11,22,27,48,159
McNeese State9,9,Shaun Johnson,SR,G,McNeese State,Southland,26,278,20,78,5,23,15,55,11,13,6,23,29,21,4,0,11,25,66
McNeese State10,10,Matthew Moss,SR,C,McNeese State,Southland,28,195,25,57,9,17,16,40,3,5,11,28,39,9,2,3,10,36,69
McNeese State11,11,Adrian Brown,FR,F,McNeese State,Southland,22,162,19,45,19,45,0,0,11,20,10,20,30,5,5,7,12,38,49
McNeese State12,12,Derrell Joubert,SO,G,McNeese State,Southland,4,13,2,4,1,1,1,3,0,0,0,2,2,0,1,0,2,2,5
McNeese State13,13,Andrija Milovanovic,JR,F,McNeese State,Southland,1,7,1,2,0,0,1,2,2,2,0,1,1,0,0,0,0,1,5
Memphis1,1,Dedric Lawson,FR,F,Memphis,AAC,33,1062,182,445,154,365,28,80,129,182,104,203,307,84,39,55,104,86,521
Memphis2,2,Ricky Tarrant,SR,G,Memphis,AAC,34,1006,104,291,59,147,45,144,146,184,13,78,91,110,46,1,51,84,399
Memphis3,3,Shaq Goodwin,SR,F,Memphis,AAC,33,976,162,338,159,326,3,12,157,216,77,172,249,49,33,61,65,105,484
Memphis4,4,Avery Woodson,JR,G,Memphis,AAC,32,840,101,238,24,59,77,179,28,40,10,72,82,46,26,9,22,80,307
Memphis5,5,Trahson Burrell,SR,F,Memphis,AAC,32,766,114,268,85,177,29,91,63,78,72,125,197,87,35,22,42,79,320
Memphis6,6,Markel Crawford,SO,G,Memphis,AAC,33,657,67,143,64,120,3,23,37,58,19,88,107,46,28,7,30,70,174
Memphis7,7,Jeremiah Martin,FR,G,Memphis,AAC,29,399,26,78,20,58,6,20,21,33,11,20,31,34,24,7,18,37,79
Memphis8,8,Nick Marshall,FR,F,Memphis,AAC,31,274,43,79,43,79,0,0,11,20,35,49,84,7,7,13,13,36,97
Memphis9,9,Sam Craft,JR,G,Memphis,AAC,17,211,14,44,10,29,4,15,5,6,4,16,20,16,6,1,8,23,37
Memphis10,10,K.J. Lawson,FR,F,Memphis,AAC,10,197,26,71,24,62,2,9,34,51,10,25,35,11,6,6,19,26,88
Memphis11,11,Craig Randall,FR,G,Memphis,AAC,24,181,20,72,12,29,8,43,4,8,6,25,31,11,6,3,18,16,52
Memphis12,12,Jake McDowell,JR,F,Memphis,AAC,24,129,6,12,6,12,0,0,2,5,3,6,9,4,3,0,5,21,14
Memphis13,13,Kedren Johnson,SR,G,Memphis,AAC,10,91,9,21,8,13,1,8,3,4,2,11,13,1,1,0,9,13,22
Memphis14,14,Caleb Wallingford,SR,G,Memphis,AAC,11,30,2,9,2,4,0,5,1,2,2,2,4,3,0,0,2,3,5
Memphis15,15,Dante Scott,FR,G,Memphis,AAC,10,27,1,15,1,9,0,6,2,3,1,5,6,0,1,0,0,1,4
Mercer1,1,Stephon Jelks,SO,F,Mercer,Southern,33,954,134,309,86,178,48,131,71,91,81,197,278,60,27,10,50,79,387
Mercer2,2,Phillip Leonard,SR,G,Mercer,Southern,33,906,118,250,115,232,3,18,117,178,35,118,153,160,15,1,60,76,356
Mercer3,3,Jordan Strawberry,SO,G,Mercer,Southern,33,836,94,246,61,155,33,91,50,60,20,60,80,121,30,1,58,46,271
Mercer4,4,Ethan Stair,FR,G,Mercer,Southern,33,794,83,194,65,133,18,61,33,52,42,94,136,33,22,6,41,71,217
Mercer5,5,Demetre Rivers,SO,G,Mercer,Southern,33,792,105,245,64,137,41,108,64,74,49,56,105,29,11,9,52,51,315
Mercer6,6,Jestin Lewis,SR,G,Mercer,Southern,23,624,116,258,69,128,47,130,43,56,9,73,82,42,35,1,36,35,322
Mercer7,7,Desmond Ringer,SO,F,Mercer,Southern,23,574,71,116,71,116,0,0,37,46,36,69,105,14,5,18,41,54,179
Mercer8,8,Lawrence Brown,JR,G,Mercer,Southern,32,388,42,76,42,76,0,0,17,26,34,41,75,4,9,7,18,58,101
Mercer9,9,Cory Kilby,FR,F,Mercer,Southern,33,270,27,64,20,40,7,24,9,13,16,37,53,11,2,5,14,29,70
Mercer10,10,Andrew Fishler,JR,C,Mercer,Southern,30,225,33,65,33,65,0,0,21,35,17,35,52,2,2,23,16,32,87
Mercer11,11,James Bento,JR,F,Mercer,Southern,27,164,9,24,9,24,0,0,2,7,18,25,43,6,4,3,6,12,20
Mercer12,12,Jaylen Stowe,FR,G,Mercer,Southern,22,93,9,28,2,13,7,15,5,10,2,13,15,5,3,0,7,13,30
Mercer13,13,Jibri Bryan,SR,G,Mercer,Southern,6,65,6,13,5,7,1,6,6,9,4,12,16,4,2,0,4,4,19
Mercer14,14,Tyre Moore,SO,G,Mercer,Southern,16,27,2,7,1,1,1,6,2,2,0,5,5,0,0,0,1,3,7
Miami (FL)1,1,Sheldon McClellan,SR,G,Miami (FL),ACC,32,1043,159,318,110,193,49,125,139,164,17,85,102,54,34,9,38,58,506
Miami (FL)2,2,Angel Rodriguez,SR,G,Miami (FL),ACC,32,949,124,289,77,140,47,149,80,101,22,57,79,141,49,5,75,82,375
Miami (FL)3,3,Tonye Jekiri,SR,C,Miami (FL),ACC,32,928,110,209,110,205,0,4,37,62,90,196,286,29,13,35,46,95,257
Miami (FL)4,4,Davon Reed,JR,G,Miami (FL),ACC,32,906,118,252,76,141,42,111,82,101,19,106,125,40,25,14,37,65,360
Miami (FL)5,5,Kamari Murphy,SR,F,Miami (FL),ACC,29,699,69,140,69,133,0,7,21,37,43,125,168,14,11,24,24,58,159
Miami (FL)6,6,Ja'Quan Newton,SO,G,Miami (FL),ACC,28,640,101,213,92,188,9,25,101,138,14,55,69,71,26,5,59,42,312
Miami (FL)7,7,Ivan Cruz Uceda,SR,F,Miami (FL),ACC,29,420,59,119,20,33,39,86,10,10,16,64,80,6,6,7,19,54,167
Miami (FL)8,8,James Palmer,SO,G,Miami (FL),ACC,31,379,38,105,26,60,12,45,22,32,10,27,37,25,14,5,15,19,110
Miami (FL)9,9,Anthony Lawrence Jr.,FR,F,Miami (FL),ACC,30,360,44,85,27,46,17,39,23,38,27,33,60,27,14,9,11,36,128
Miami (FL)10,10,Ebuka Izundu,FR,C,Miami (FL),ACC,13,76,10,16,10,16,0,0,12,19,11,6,17,3,2,2,6,17,32
Miami (FL)11,11,Mike Robinson,FR,G,Miami (FL),ACC,8,13,5,9,1,2,4,7,0,0,0,1,1,0,0,0,0,3,14
Miami (OH)1,1,Geovonie McKnight,SR,G,Miami (OH),MAC,32,1029,156,364,150,341,6,23,103,137,39,88,127,72,34,7,77,72,421
Miami (OH)2,2,Eric Washington,SR,G,Miami (OH),MAC,30,995,125,285,86,181,39,104,127,159,16,94,110,138,47,0,82,53,416
Miami (OH)3,3,Rod Mills,SO,F,Miami (OH),MAC,33,643,65,183,37,92,28,91,17,24,15,67,82,15,14,1,37,69,175
Miami (OH)4,4,Abdoulaye Harouna,SO,G,Miami (OH),MAC,33,630,57,157,24,60,33,97,32,45,6,53,59,14,26,5,38,64,179
Miami (OH)5,5,Dion Wade,SO,G,Miami (OH),MAC,33,580,41,137,11,29,30,108,23,30,23,98,121,24,34,13,17,66,135
Miami (OH)6,6,Chris Bryant,SR,F,Miami (OH),MAC,31,556,67,130,67,130,0,0,47,73,46,71,117,6,17,10,30,63,181
Miami (OH)7,7,Willie Moore,SR,G,Miami (OH),MAC,29,524,29,110,18,61,11,49,38,50,19,64,83,33,21,2,42,46,107
Miami (OH)8,8,L.J. Livingston,SR,F,Miami (OH),MAC,31,473,56,89,56,89,0,0,33,49,54,53,107,1,3,29,12,48,145
Miami (OH)9,9,Logan McLane,SO,F,Miami (OH),MAC,24,287,28,81,20,56,8,25,17,24,18,37,55,11,8,4,22,35,81
Miami (OH)10,10,Zach McCormick,SO,G,Miami (OH),MAC,16,259,22,67,15,37,7,30,8,13,6,15,21,11,4,1,6,24,59
Miami (OH)11,11,Kalif Wright,SR,F,Miami (OH),MAC,25,239,36,79,35,78,1,1,6,14,18,27,45,2,5,0,7,34,79
Miami (OH)12,12,Ali Barnes,SO,G,Miami (OH),MAC,14,195,17,48,6,15,11,33,7,8,1,11,12,5,4,0,10,23,52
Miami (OH)13,13,Brian Oddo,SR,F,Miami (OH),MAC,10,87,5,15,2,3,3,12,3,4,4,10,14,3,0,0,5,9,16
Miami (OH)14,14,Jere Vucica,SR,F,Miami (OH),MAC,8,86,15,32,14,26,1,6,10,16,11,10,21,1,1,0,3,8,41
Michigan1,1,Zak Irvin,JR,G,Michigan,Big Ten,33,1075,147,358,102,211,45,147,48,74,16,135,151,101,25,1,62,40,387
Michigan2,2,Derrick Walton,JR,G,Michigan,Big Ten,31,1041,107,282,48,132,59,150,89,109,16,160,176,138,51,3,62,59,362
Michigan3,3,Duncan Robinson,SO,G,Michigan,Big Ten,34,967,126,276,36,75,90,201,38,42,21,90,111,59,22,6,34,76,380
Michigan4,4,Muhammad-Ali Abdur-Rahkman,SO,G,Michigan,Big Ten,34,925,106,225,78,147,28,78,40,58,20,71,91,56,21,9,27,58,280
Michigan5,5,Mark Donnal,SO,F,Michigan,Big Ten,32,617,99,171,89,139,10,32,46,64,55,66,121,11,12,24,24,79,254
Michigan6,6,Aubrey Dawkins,SO,G,Michigan,Big Ten,34,548,83,165,40,69,43,96,21,29,22,63,85,18,16,5,20,44,230
Michigan7,7,Caris LeVert,SR,G,Michigan,Big Ten,15,464,82,162,53,97,29,65,54,68,9,71,80,74,15,3,25,18,247
Michigan8,8,Ricky Doyle,SO,F,Michigan,Big Ten,34,429,51,80,51,80,0,0,31,50,31,39,70,2,2,7,22,61,133
Michigan9,9,Moritz Wagner,FR,F,Michigan,Big Ten,28,228,32,56,30,44,2,12,10,18,16,22,38,3,4,2,13,41,76
Michigan10,10,Kameron Chatman,SO,G,Michigan,Big Ten,27,197,29,71,20,40,9,31,11,15,15,22,37,14,6,4,7,22,78
Michigan11,11,D.J. Wilson,FR,F,Michigan,Big Ten,26,158,27,57,19,33,8,24,8,11,4,14,18,8,5,10,9,21,70
Michigan12,12,Andrew Dakich,JR,G,Michigan,Big Ten,22,103,5,12,4,6,1,6,3,3,3,11,14,14,6,0,8,9,14
Michigan13,13,Spike Albrecht,SR,G,Michigan,Big Ten,9,73,4,11,2,4,2,7,5,7,1,5,6,11,3,0,1,2,15
Michigan State1,1,Denzel Valentine,SR,G,Michigan State,Big Ten,30,985,200,431,99,205,101,226,81,95,23,204,227,229,30,7,79,48,582
Michigan State2,2,Bryn Forbes,SR,G,Michigan State,Big Ten,34,952,161,331,53,108,108,223,61,73,12,61,73,51,13,1,29,48,491
Michigan State3,3,Matt Costello,SR,F,Michigan State,Big Ten,34,771,139,254,137,246,2,8,72,96,100,179,279,44,22,41,38,72,352
Michigan State4,4,Eron Harris,JR,G,Michigan State,Big Ten,34,708,105,246,64,150,41,96,66,82,25,63,88,70,9,3,48,74,317
Michigan State5,5,Deyonta Davis,FR,F,Michigan State,Big Ten,34,635,114,191,114,191,0,0,23,38,70,118,188,26,9,63,30,78,251
Michigan State6,6,Matt McQuaid,FR,G,Michigan State,Big Ten,34,539,43,110,17,47,26,63,8,11,10,18,28,57,13,10,26,58,120
Michigan State7,7,Lourawls Nairn,SO,G,Michigan State,Big Ten,27,516,33,87,30,71,3,16,10,23,3,28,31,91,8,1,25,41,79
Michigan State8,8,Javon Bess,SO,F,Michigan State,Big Ten,31,344,31,72,30,63,1,9,31,54,23,50,73,21,9,7,13,38,94
Michigan State9,9,Gavin Schilling,JR,F,Michigan State,Big Ten,23,288,32,64,32,64,0,0,23,35,24,48,72,15,8,8,21,39,87
Michigan State10,10,Marvin Clark,SO,F,Michigan State,Big Ten,29,288,44,82,34,57,10,25,15,20,22,53,75,10,8,11,19,48,113
Michigan State11,11,Kenny Goins,FR,F,Michigan State,Big Ten,25,262,20,28,20,28,0,0,12,21,24,51,75,19,4,11,15,32,52
Michigan State12,12,Alvin Ellis,JR,G,Michigan State,Big Ten,32,243,27,65,13,30,14,35,17,24,11,37,48,35,11,4,14,27,85
Michigan State13,13,Colby Wollenman,SR,F,Michigan State,Big Ten,30,181,13,24,13,24,0,0,9,13,18,29,47,20,1,4,16,28,35
Michigan State14,14,Kyle Ahrens,FR,G,Michigan State,Big Ten,25,86,10,24,6,11,4,13,7,10,8,8,16,7,2,2,9,10,31
Michigan State15,15,Matt Van Dyk,JR,F,Michigan State,Big Ten,20,49,7,14,7,14,0,0,9,13,2,11,13,4,3,2,3,8,23
Middle Tennessee1,1,Reggie Upshaw,JR,F,Middle Tennessee,CUSA,33,1024,176,348,152,284,24,64,81,159,95,191,286,71,49,26,61,75,457
Middle Tennessee2,2,Perrin Buford,SR,F,Middle Tennessee,CUSA,33,943,155,301,140,265,15,36,72,104,61,133,194,62,25,38,61,86,397
Middle Tennessee3,3,Darnell Harris,SR,F,Middle Tennessee,CUSA,33,877,129,310,75,174,54,136,71,112,42,91,133,40,17,23,43,85,383
Middle Tennessee4,4,Jaqawn Raymond,SR,G,Middle Tennessee,CUSA,33,759,52,133,25,50,27,83,35,55,11,55,66,59,29,4,45,77,166
Middle Tennessee5,5,Giddy Potts,SO,G,Middle Tennessee,CUSA,27,742,130,264,57,119,73,145,57,76,24,119,143,34,28,9,29,83,390
Middle Tennessee6,6,Edward Simpson,SO,G,Middle Tennessee,CUSA,30,651,51,137,22,52,29,85,19,39,12,67,79,54,15,2,26,53,150
Middle Tennessee7,7,Quavius Copeland,SO,G,Middle Tennessee,CUSA,33,508,63,153,52,108,11,45,21,33,2,28,30,63,13,0,51,41,158
Middle Tennessee8,8,Xavier Habersham,JR,F,Middle Tennessee,CUSA,32,372,37,102,15,41,22,61,9,17,12,40,52,9,3,5,12,44,105
Middle Tennessee9,9,Jacob Ivory,SO,G,Middle Tennessee,CUSA,16,257,14,41,13,34,1,7,31,34,2,23,25,28,11,1,16,27,60
Middle Tennessee10,10,Aldonis Foote,JR,G,Middle Tennessee,CUSA,27,226,29,61,25,51,4,10,13,23,14,41,55,11,10,1,15,43,75
Middle Tennessee11,11,Joshua Phillips,JR,F,Middle Tennessee,CUSA,27,144,12,24,12,23,0,1,7,16,12,31,43,0,4,3,16,31,31
Middle Tennessee12,12,Karl Gamble,FR,F,Middle Tennessee,CUSA,30,122,9,28,9,28,0,0,9,21,11,20,31,0,1,4,8,27,27
Milwaukee1,1,Jordan Johnson,JR,G,Milwaukee,Horizon,32,1134,113,264,88,185,25,79,149,190,19,98,117,259,29,1,90,64,400
Milwaukee2,2,Austin Arians,JR,F,Milwaukee,Horizon,33,1029,127,321,48,97,79,224,44,52,26,101,127,42,25,6,21,64,377
Milwaukee3,3,Akeem Springs,JR,G,Milwaukee,Horizon,32,1022,154,314,115,203,39,111,76,107,34,137,171,54,27,2,46,65,423
Milwaukee4,4,Matt Tiby,SR,F,Milwaukee,Horizon,33,993,155,340,112,225,43,115,161,195,60,212,272,66,11,10,68,78,514
Milwaukee5,5,J.J. Panoske,SR,F,Milwaukee,Horizon,33,754,135,263,92,157,43,106,32,41,37,135,172,46,6,54,44,89,345
Milwaukee6,6,Cody Wichmann,JR,G,Milwaukee,Horizon,33,507,52,109,10,22,42,87,11,17,22,45,67,28,12,2,10,56,157
Milwaukee7,7,J.R. Lyle,SR,G,Milwaukee,Horizon,30,379,41,87,26,40,15,47,22,33,11,14,25,12,13,1,17,41,119
Milwaukee8,8,Brock Stull,FR,G,Milwaukee,Horizon,30,273,27,61,20,36,7,25,16,22,13,39,52,21,7,3,13,25,77
Milwaukee9,9,JayQuan McCloud,FR,G,Milwaukee,Horizon,18,247,33,83,24,54,9,29,20,25,13,18,31,15,8,5,16,27,95
Milwaukee10,10,Brett Prahl,SO,F,Milwaukee,Horizon,24,99,12,16,12,15,0,1,5,10,10,8,18,2,1,1,9,23,29
Milwaukee11,11,Justin Jordan,SO,G,Milwaukee,Horizon,4,63,4,13,4,11,0,2,0,0,0,5,5,2,1,0,7,3,8
Milwaukee12,12,Derek Rongstad,FR,G,Milwaukee,Horizon,11,56,7,13,4,8,3,5,3,4,8,4,12,3,4,0,4,5,20
Milwaukee13,13,Scotty Tyler,SO,F,Milwaukee,Horizon,12,49,5,12,5,11,0,1,0,0,9,6,15,4,1,1,1,10,10
Milwaukee14,14,Alex Prahl,SO,F,Milwaukee,Horizon,11,44,5,7,5,7,0,0,5,6,1,3,4,1,1,0,4,6,15
Milwaukee15,15,Dan Studer,JR,F,Milwaukee,Horizon,8,34,5,14,5,10,0,4,2,6,3,5,8,3,2,0,3,4,12
Milwaukee16,16,Jeremy Johnson,FR,G,Milwaukee,Horizon,1,27,3,4,2,2,1,2,7,8,0,1,1,8,1,0,1,0,14
Milwaukee17,17,Baylor Peterson,FR,F,Milwaukee,Horizon,4,15,1,6,1,2,0,4,1,2,0,1,1,0,0,0,0,2,3
Minnesota1,1,Nate Mason,SO,G,Minnesota,Big Ten,27,888,130,334,91,205,39,129,74,93,8,69,77,121,24,1,46,53,373
Minnesota2,2,Joey King,SR,F,Minnesota,Big Ten,29,854,99,235,40,89,59,146,78,88,27,83,110,38,15,9,27,85,335
Minnesota3,3,Jordan Murphy,FR,F,Minnesota,Big Ten,31,822,135,293,126,252,9,41,82,134,86,161,247,22,32,32,55,103,361
Minnesota4,4,Charles Buggs,JR,F,Minnesota,Big Ten,28,675,60,131,37,59,23,72,20,26,17,62,79,18,17,14,26,50,163
Minnesota5,5,Bakary Konate,SO,C,Minnesota,Big Ten,31,665,56,110,56,108,0,2,38,56,49,109,158,13,6,32,36,85,150
Minnesota6,6,Dupree McBrayer,FR,G,Minnesota,Big Ten,27,617,44,135,32,87,12,48,59,95,7,56,63,68,27,3,33,50,159
Minnesota7,7,Carlos Morris,SR,G,Minnesota,Big Ten,24,613,86,221,61,150,25,71,39,56,13,72,85,34,19,6,44,32,236
Minnesota8,8,Kevin Dorsey,FR,G,Minnesota,Big Ten,26,484,58,161,50,118,8,43,54,75,11,49,60,37,12,6,36,43,178
Minnesota9,9,Ahmad Gilbert,FR,G,Minnesota,Big Ten,21,295,28,91,18,47,10,44,5,11,9,31,40,17,13,3,13,25,71
Minnesota10,10,Stephon Sharp,FR,G,Minnesota,Big Ten,15,186,19,50,14,33,5,17,15,20,8,6,14,10,1,3,16,15,58
Minnesota11,11,Gaston Diedhiou,SO,F,Minnesota,Big Ten,24,131,6,18,6,18,0,0,5,8,9,9,18,1,3,3,5,22,17
Minnesota12,12,Mike Lukashewich,SO,G,Minnesota,Big Ten,4,26,2,2,1,1,1,1,0,0,1,2,3,0,1,0,1,2,5
Minnesota13,13,Darin Haugh,JR,G,Minnesota,Big Ten,6,19,1,4,1,2,0,2,0,0,0,0,0,0,0,0,3,0,2
Mississippi1,1,Stefan Moody,SR,G,Mississippi,SEC,31,1072,208,510,105,238,103,272,212,256,31,69,100,133,46,3,118,75,731
Mississippi2,2,Rasheed Brooks,JR,G,Mississippi,SEC,32,880,101,272,57,124,44,148,21,38,19,86,105,52,42,10,30,65,267
Mississippi3,3,Tomasz Gielo,SR,F,Mississippi,SEC,32,877,110,283,56,129,54,154,43,53,26,111,137,51,17,13,36,85,317
Mississippi4,4,Martavious Newby,SR,G,Mississippi,SEC,30,835,38,113,30,77,8,36,62,88,69,93,162,71,41,6,49,76,146
Mississippi5,5,Sebastian Saiz,JR,F,Mississippi,SEC,26,741,115,234,113,224,2,10,73,112,79,148,227,17,23,28,35,78,305
Mississippi6,6,Anthony Perez,SR,F,Mississippi,SEC,31,721,70,165,40,89,30,76,46,67,46,80,126,31,19,8,36,88,216
Mississippi7,7,Marcanvis Hymon,FR,F,Mississippi,SEC,32,565,78,149,78,149,0,0,39,73,67,99,166,15,22,29,21,80,195
Mississippi8,8,Donte Fitzpatrick-Dorsey,FR,G,Mississippi,SEC,21,255,25,52,23,46,2,6,25,35,9,16,25,20,12,0,26,31,77
Mississippi9,9,Sam Finley,JR,G,Mississippi,SEC,17,214,27,76,25,58,2,18,30,45,5,24,29,9,9,1,15,16,86
Mississippi10,10,Terence Davis,FR,G,Mississippi,SEC,20,132,13,30,10,19,3,11,7,19,7,12,19,6,7,2,5,22,36
Mississippi11,11,J.T. Escobar,FR,G,Mississippi,SEC,17,82,7,22,4,8,3,14,3,5,0,2,2,7,1,0,8,8,20
Mississippi12,12,Terry Brutus,JR,F,Mississippi,SEC,7,50,2,8,2,8,0,0,0,0,2,4,6,0,2,0,2,6,4
Mississippi13,13,Jake Coddington,JR,F,Mississippi,SEC,12,26,2,2,1,1,1,1,0,0,1,1,2,0,1,0,0,5,5
Mississippi State1,1,Craig Sword,SR,G,Mississippi State,SEC,31,905,143,317,120,218,23,99,94,139,35,86,121,94,41,29,97,102,403
Mississippi State2,2,I.J. Ready,JR,G,Mississippi State,SEC,30,886,103,247,77,156,26,91,45,56,12,67,79,134,39,1,48,56,277
Mississippi State3,3,Gavin Ware,SR,F,Mississippi State,SEC,30,842,183,298,183,297,0,1,95,126,87,147,234,27,28,32,55,83,461
Mississippi State4,4,Quinndary Weatherspoon,FR,G,Mississippi State,SEC,31,836,133,297,90,188,43,109,62,77,47,99,146,43,42,16,45,75,371
Mississippi State5,5,Malik Newman,FR,G,Mississippi State,SEC,29,803,111,284,50,123,61,161,46,67,8,73,81,63,11,2,54,45,329
Mississippi State6,6,Travis Daniels,SR,G,Mississippi State,SEC,29,677,63,133,43,83,20,50,18,27,55,76,131,22,14,19,30,66,164
Mississippi State7,7,Fred Thomas,SR,G,Mississippi State,SEC,31,629,54,135,22,37,32,98,30,39,10,79,89,31,10,13,17,50,170
Mississippi State8,8,Johnny Zuppardo,SR,F,Mississippi State,SEC,31,358,38,93,20,44,18,49,4,6,15,51,66,7,14,5,13,60,98
Mississippi State9,9,Aric Holman,FR,F,Mississippi State,SEC,21,193,18,44,16,31,2,13,1,6,9,30,39,8,2,14,16,37,39
Mississippi State10,10,Fallou Ndoye,SO,F,Mississippi State,SEC,6,45,1,2,1,2,0,0,0,1,4,3,7,1,0,1,3,16,2
Mississippi State11,11,Reggie Patterson,JR,G,Mississippi State,SEC,8,14,2,5,2,4,0,1,2,3,0,1,1,0,0,0,1,4,6
Mississippi State12,12,Demetrius Houston,SO,F,Mississippi State,SEC,1,6,1,1,1,1,0,0,0,0,0,0,0,0,0,0,0,0,2
Mississippi Valley State1,1,Isaac Williams,JR,G,Mississippi Valley State,SWAC,35,882,145,388,79,177,66,211,50,63,15,105,120,30,22,7,27,65,406
Mississippi Valley State2,2,Marcus Romain,JR,G,Mississippi Valley State,SWAC,30,869,188,429,158,341,30,88,152,200,30,131,161,71,34,11,108,69,558
Mississippi Valley State3,3,Kylan Phillips,FR,G,Mississippi Valley State,SWAC,34,809,48,192,30,124,18,68,27,35,10,41,51,59,29,1,56,62,141
Mississippi Valley State4,4,Ta'Jay Henry,JR,F,Mississippi Valley State,SWAC,34,699,66,144,66,142,0,2,36,59,64,78,142,21,20,11,35,94,168
Mississippi Valley State5,5,Vacha Vaughn,JR,F,Mississippi Valley State,SWAC,35,686,52,127,52,118,0,9,29,43,44,106,150,39,21,1,34,88,133
Mississippi Valley State6,6,Damian Young,JR,F,Mississippi Valley State,SWAC,34,680,93,259,59,154,34,105,50,63,23,65,88,32,54,10,54,63,270
Mississippi Valley State7,7,Rashaan Surles,JR,G,Mississippi Valley State,SWAC,34,644,52,165,34,107,18,58,19,35,14,79,93,78,22,15,49,55,141
Mississippi Valley State8,8,Latrell Love,SR,C,Mississippi Valley State,SWAC,35,554,73,191,73,188,0,3,74,116,18,53,71,12,9,9,31,36,220
Mississippi Valley State9,9,Jabari Alex,SR,F,Mississippi Valley State,SWAC,35,371,42,63,42,62,0,1,2,4,25,36,61,7,12,8,15,38,86
Mississippi Valley State10,10,Dwain Whitfield,SO,F,Mississippi Valley State,SWAC,33,256,12,29,12,29,0,0,3,4,21,20,41,5,3,0,9,26,27
Mississippi Valley State11,11,Michael Matlock,JR,F,Mississippi Valley State,SWAC,13,225,16,40,16,40,0,0,13,31,27,41,68,10,7,1,11,28,45
Mississippi Valley State12,12,Ronald Strother Jr.,FR,F,Mississippi Valley State,SWAC,24,186,14,41,13,31,1,10,5,10,12,20,32,3,5,7,10,10,34
Mississippi Valley State13,13,John Sanders,JR,G,Mississippi Valley State,SWAC,16,132,8,19,5,12,3,7,2,2,3,7,10,6,3,0,8,17,21
Mississippi Valley State14,14,Dusan Langura,JR,G,Mississippi Valley State,SWAC,16,84,10,31,1,3,9,28,0,0,1,7,8,0,0,1,2,9,29
Mississippi Valley State15,15,Bennett Davis,JR,C,Mississippi Valley State,SWAC,10,43,6,7,6,7,0,0,0,2,5,4,9,0,0,0,5,9,12
Mississippi Valley State16,16,Amir Savon,FR,F,Mississippi Valley State,SWAC,7,34,1,4,1,4,0,0,0,0,0,2,2,0,0,0,0,2,2
Missouri1,1,Namon Wright,SO,G,Missouri,SEC,31,820,86,242,47,118,39,124,86,113,22,138,160,40,14,7,57,62,297
Missouri2,2,Terrence Phillips,FR,G,Missouri,SEC,31,812,81,212,52,122,29,90,52,72,20,110,130,107,40,3,71,107,243
Missouri3,3,Kevin Puryear,FR,F,Missouri,SEC,31,767,120,258,107,217,13,41,102,122,40,104,144,13,12,4,50,51,355
Missouri4,4,Wes Clark,JR,G,Missouri,SEC,25,662,80,216,50,136,30,80,55,66,14,61,75,73,23,4,53,63,245
Missouri5,5,Ryan Rosburg,SR,F,Missouri,SEC,31,614,92,147,92,147,0,0,48,87,35,84,119,15,10,15,26,89,232
Missouri6,6,Cullen VanLeer,FR,G,Missouri,SEC,31,533,45,138,15,28,30,110,5,8,7,29,36,24,10,1,14,37,125
Missouri7,7,Jakeenan Gant,SO,F,Missouri,SEC,30,468,60,133,54,110,6,23,26,36,40,73,113,7,12,29,21,60,152
Missouri8,8,Tramaine Isabell,SO,G,Missouri,SEC,28,457,59,156,46,105,13,51,42,57,8,40,48,35,23,1,41,31,173
Missouri9,9,K.J. Walton,FR,G,Missouri,SEC,31,427,50,115,39,85,11,30,54,78,24,34,58,27,14,2,23,35,165
Missouri10,10,Russell Woods,JR,F,Missouri,SEC,29,388,33,63,33,63,0,0,14,36,27,50,77,9,4,7,13,74,80
Missouri11,11,D'Angelo Allen,SO,F,Missouri,SEC,21,177,20,38,19,34,1,4,3,13,13,27,40,8,4,6,9,18,44
Missouri12,12,Jimmy Barton,SO,G,Missouri,SEC,12,46,2,10,0,2,2,8,0,0,1,3,4,4,2,0,5,6,6
Missouri13,13,Adam Wolf,FR,F,Missouri,SEC,7,25,4,8,3,4,1,4,0,0,1,7,8,0,1,2,0,3,9
Missouri State1,1,Dequon Miller,JR,G,Missouri State,MVC,32,1110,132,369,75,194,57,175,85,123,17,82,99,96,18,0,82,63,406
Missouri State2,2,Obediah Church,FR,F,Missouri State,MVC,32,861,86,144,86,141,0,3,31,76,62,133,195,47,22,50,49,63,203
Missouri State3,3,Chris Kendrix,SO,F,Missouri State,MVC,30,837,100,247,56,123,44,124,120,149,32,113,145,33,30,17,61,74,364
Missouri State4,4,Camyn Boone,SR,F,Missouri State,MVC,31,775,143,284,143,284,0,0,92,133,59,144,203,37,9,15,43,66,378
Missouri State5,5,Jarred Dixon,FR,G,Missouri State,MVC,30,725,91,222,80,181,11,41,47,64,22,46,68,45,40,4,30,60,240
Missouri State6,6,Dorrian Williams,SR,G,Missouri State,MVC,20,606,56,151,49,115,7,36,26,35,4,83,87,77,27,1,32,44,145
Missouri State7,7,Ryan Kreklow,FR,G,Missouri State,MVC,28,596,57,164,18,51,39,113,34,45,12,50,62,35,21,7,33,62,187
Missouri State8,8,Loomis Gerring,SR,F,Missouri State,MVC,26,276,28,86,24,66,4,20,17,25,17,35,52,4,7,5,22,42,77
Missouri State9,9,Jordan Martin,JR,F,Missouri State,MVC,27,217,20,53,20,53,0,0,14,36,24,18,42,6,11,11,25,65,54
Missouri State10,10,Tyler McCullough,JR,C,Missouri State,MVC,28,207,17,39,17,39,0,0,8,12,23,27,50,5,3,14,14,43,42
Missouri State11,11,Robin Thompson,FR,F,Missouri State,MVC,19,126,12,25,12,24,0,1,6,13,12,11,23,3,9,6,7,28,30
Missouri State12,12,Austin Ruder,JR,G,Missouri State,MVC,5,78,6,22,1,6,5,16,1,1,0,7,7,1,1,0,2,7,18
Missouri State13,13,Shawn Roundtree,SO,G,Missouri State,MVC,3,35,4,11,3,7,1,4,0,1,1,0,1,1,1,0,2,5,9
Missouri-Kansas City1,1,LaVell Boyd,JR,G,Missouri-Kansas City,WAC,31,1014,149,345,68,152,81,193,59,73,13,92,105,70,24,4,45,78,438
Missouri-Kansas City2,2,Martez Harrison,JR,G,Missouri-Kansas City,WAC,30,999,135,347,96,221,39,126,154,201,25,86,111,126,38,3,110,76,463
Missouri-Kansas City3,3,Darius Austin,SO,G,Missouri-Kansas City,WAC,30,762,80,220,68,179,12,41,46,74,35,99,134,44,23,12,49,77,218
Missouri-Kansas City4,4,Kyle Steward,JR,F,Missouri-Kansas City,WAC,31,650,72,168,39,95,33,73,35,44,37,83,120,18,18,13,30,58,212
Missouri-Kansas City5,5,Shayok M. Shayok,SR,F,Missouri-Kansas City,WAC,26,611,82,150,78,140,4,10,23,60,46,89,135,10,17,12,28,76,191
Missouri-Kansas City6,6,Dashawn King,JR,G,Missouri-Kansas City,WAC,31,601,91,211,77,158,14,53,60,85,33,53,86,52,30,3,57,63,256
Missouri-Kansas City7,7,Darnell Tillman,JR,C,Missouri-Kansas City,WAC,31,381,35,63,35,63,0,0,15,28,45,49,94,4,9,16,21,65,85
Missouri-Kansas City8,8,Thaddeus Smith,SR,C,Missouri-Kansas City,WAC,28,324,19,34,19,34,0,0,4,20,32,54,86,2,9,20,19,68,42
Missouri-Kansas City9,9,Broderick Newbill,JR,G,Missouri-Kansas City,WAC,17,288,35,75,32,61,3,14,30,42,20,36,56,7,6,7,13,18,103
Missouri-Kansas City10,10,Aleer Leek,FR,F,Missouri-Kansas City,WAC,30,248,22,56,11,29,11,27,7,18,11,21,32,3,2,5,14,33,62
Missouri-Kansas City11,11,Grant Leach,FR,G,Missouri-Kansas City,WAC,24,241,15,42,3,7,12,35,5,6,2,12,14,11,3,0,9,25,47
Missouri-Kansas City12,12,Noah Knight,SO,G,Missouri-Kansas City,WAC,3,61,8,16,6,7,2,9,4,6,3,7,10,2,2,3,2,11,22
Missouri-Kansas City13,13,Ikem Eriobuna,JR,F,Missouri-Kansas City,WAC,8,44,3,11,1,4,2,7,5,6,2,5,7,1,0,0,2,3,13
Monmouth1,1,Justin Robinson,JR,G,Monmouth,MAAC,34,1113,204,458,128,267,76,191,180,213,19,107,126,125,76,0,76,52,664
Monmouth2,2,Micah Seaborn,FR,G,Monmouth,MAAC,34,942,150,351,83,183,67,168,77,92,16,92,108,66,33,6,61,73,444
Monmouth3,3,Josh James,JR,G,Monmouth,MAAC,34,848,41,122,31,85,10,37,26,43,30,75,105,49,21,3,28,66,118
Monmouth4,4,Je'lon Hornbeak,JR,G,Monmouth,MAAC,32,687,83,216,36,98,47,118,65,83,24,74,98,57,44,8,62,106,278
Monmouth5,5,Deon Jones,SR,G,Monmouth,MAAC,29,686,108,237,93,199,15,38,66,91,37,147,184,35,19,23,38,72,297
Monmouth6,6,Chris Brady,JR,C,Monmouth,MAAC,34,627,100,181,98,173,2,8,34,48,69,137,206,9,22,45,37,90,236
Monmouth7,7,Austin Tilghman,SO,G,Monmouth,MAAC,34,582,63,110,61,102,2,8,57,96,20,72,92,35,33,0,47,42,185
Monmouth8,8,Collin Stewart,JR,G,Monmouth,MAAC,34,564,74,223,30,83,44,140,51,58,21,62,83,22,17,14,31,41,243
Monmouth9,9,Diago Quinn,FR,F,Monmouth,MAAC,34,329,29,53,29,53,0,0,30,36,28,49,77,6,6,8,14,87,88
Monmouth10,10,Zac Tillman,JR,C,Monmouth,MAAC,31,309,37,83,37,83,0,0,27,32,27,44,71,9,6,13,8,63,101
Monmouth11,11,Pierre Sarr,FR,F,Monmouth,MAAC,23,128,13,27,11,21,2,6,3,10,12,25,37,3,5,2,8,23,31
Monmouth12,12,Daniel Pillari,SO,G,Monmouth,MAAC,20,34,3,13,1,5,2,8,7,11,0,4,4,1,1,0,3,5,15
Montana1,1,Walter Wright,JR,G,Montana,Big Sky,32,1044,143,354,99,230,44,124,90,114,22,94,116,145,33,0,82,84,420
Montana2,2,Michael Oguine,FR,G,Montana,Big Sky,32,982,115,284,84,186,31,98,98,140,21,124,145,59,33,13,60,93,359
Montana3,3,Martin Breunig,SR,F,Montana,Big Sky,32,970,220,355,217,345,3,10,161,228,96,194,290,46,22,37,70,105,604
Montana4,4,Brandon Gfeller,JR,G,Montana,Big Sky,32,779,81,207,9,23,72,184,39,50,13,59,72,35,21,5,27,93,273
Montana5,5,Jack Lopez,JR,G,Montana,Big Sky,32,744,65,122,29,40,36,82,15,20,17,65,82,41,16,9,35,80,181
Montana6,6,Fabijan Krslovic,SO,F,Montana,Big Sky,32,639,58,118,58,116,0,2,26,54,53,80,133,45,22,9,42,82,142
Montana7,7,Bobby Moorehead,FR,G,Montana,Big Sky,32,570,64,157,17,37,47,120,6,11,8,58,66,20,8,3,20,47,181
Montana8,8,Mario Dunn,JR,G,Montana,Big Sky,20,335,33,71,28,49,5,22,7,12,6,31,37,21,8,1,25,40,78
Montana9,9,Riley Bradshaw,JR,G,Montana,Big Sky,25,156,8,29,4,13,4,16,5,8,0,10,10,10,1,0,7,15,25
Montana10,10,Bryden Boehning,SO,C,Montana,Big Sky,21,133,13,28,13,28,0,0,2,7,6,22,28,6,2,1,10,34,28
Montana11,11,Gavin DeJong,SO,F,Montana,Big Sky,20,98,12,25,12,25,0,0,3,7,8,16,24,3,3,3,8,17,27
Montana State1,1,Marcus Colbert,SR,G,Montana State,Big Sky,31,1040,187,444,135,294,52,150,95,130,26,69,95,158,34,3,83,96,521
Montana State2,2,Tyler Hall,FR,G,Montana State,Big Sky,31,993,202,442,106,219,96,223,78,90,26,137,163,51,28,8,56,68,578
Montana State3,3,Zach Green,SO,G,Montana State,Big Sky,31,776,98,209,85,161,13,48,53,90,70,102,172,45,15,2,38,79,262
Montana State4,4,Danny Robison,SR,F,Montana State,Big Sky,31,677,56,126,45,83,11,43,52,75,63,59,122,14,14,8,31,102,175
Montana State5,5,Quinton Everett,JR,G,Montana State,Big Sky,29,647,71,184,53,127,18,57,46,81,52,100,152,38,28,14,29,72,206
Montana State6,6,Sarp Gobeloglu,JR,F,Montana State,Big Sky,31,627,91,202,37,64,54,138,24,29,27,83,110,19,7,14,37,70,260
Montana State7,7,Stephan Holm,JR,G,Montana State,Big Sky,25,450,62,138,28,58,34,80,8,17,9,49,58,16,10,2,22,29,166
Montana State8,8,Nahjee Matlock,JR,G,Montana State,Big Sky,30,311,19,73,11,45,8,28,13,20,15,29,44,30,4,2,33,31,59
Montana State9,9,Sam Neumann,FR,F,Montana State,Big Sky,28,270,19,38,8,8,11,30,15,25,11,35,46,13,2,1,4,35,64
Montana State10,10,Shikei Blake,JR,C,Montana State,Big Sky,24,219,19,45,19,45,0,0,18,24,22,26,48,1,5,2,13,53,56
Montana State11,11,Tyson Kanseyo,SO,F,Montana State,Big Sky,26,209,7,14,7,14,0,0,8,17,17,41,58,7,2,6,20,46,22
Morehead State1,1,Brent Arrington,SR,G,Morehead State,OVC,31,873,105,294,77,193,28,101,64,83,38,67,105,99,49,11,68,100,302
Morehead State2,2,DeJuan Marrero,JR,F,Morehead State,OVC,31,750,95,208,95,208,0,0,51,98,81,147,228,39,35,22,65,88,241
Morehead State3,3,Xavier Moon,JR,G,Morehead State,OVC,31,734,116,239,77,145,39,94,36,51,14,65,79,50,29,4,27,69,307
Morehead State4,4,Corban Collins,JR,G,Morehead State,OVC,24,707,90,238,41,124,49,114,54,76,10,53,63,74,26,2,30,49,283
Morehead State5,5,Anthony Elechi,SR,F,Morehead State,OVC,31,614,105,186,105,186,0,0,60,76,90,85,175,11,16,9,30,103,270
Morehead State6,6,Lyonell Gaines,SR,F,Morehead State,OVC,31,509,61,131,56,112,5,19,39,54,44,52,96,15,11,3,24,46,166
Morehead State7,7,Miguel Dicent,SO,G,Morehead State,OVC,25,503,69,150,37,72,32,78,25,34,16,45,61,41,17,5,30,63,195
Morehead State8,8,Malik Maitland,FR,G,Morehead State,OVC,22,397,37,122,22,77,15,45,43,54,10,26,36,68,27,4,48,39,132
Morehead State9,9,Ronnye Beamon,JR,F,Morehead State,OVC,31,361,27,68,22,55,5,13,25,45,21,29,50,12,14,7,19,60,84
Morehead State10,10,Treshaad Williams,JR,F,Morehead State,OVC,31,332,37,56,37,56,0,0,29,42,39,35,74,9,12,1,15,43,103
Morehead State11,11,Lamontray Harris,FR,F,Morehead State,OVC,28,286,33,83,24,61,9,22,15,26,12,34,46,11,2,6,14,30,90
Morehead State12,12,Ty'Quan Bitting,JR,F,Morehead State,OVC,17,120,17,30,17,30,0,0,4,5,6,7,13,2,3,1,7,14,38
Morehead State13,13,Jared Ravenscraft,SR,G,Morehead State,OVC,7,35,7,10,4,5,3,5,2,3,3,2,5,7,5,0,1,0,19
Morehead State14,14,Wes Noble,FR,F,Morehead State,OVC,7,29,2,11,1,6,1,5,8,10,3,4,7,4,0,0,3,4,13
Morgan State1,1,Phillip Carr,SO,F,Morgan State,MEAC,31,932,107,280,78,194,29,86,82,110,62,153,215,37,14,35,43,72,325
Morgan State2,2,Donte Pretlow,SR,G,Morgan State,MEAC,30,892,78,209,69,171,9,38,46,74,14,77,91,123,40,0,63,48,211
Morgan State3,3,Cedric Blossom,SR,F,Morgan State,MEAC,26,854,149,293,146,277,3,16,89,136,57,115,172,25,20,1,45,61,390
Morgan State4,4,Rasean Simpson,SR,G,Morgan State,MEAC,25,807,104,219,101,213,3,6,94,133,64,105,169,17,36,8,39,73,305
Morgan State5,5,Kyle Thomas,JR,F,Morgan State,MEAC,30,611,81,226,53,131,28,95,33,47,26,62,88,13,13,17,37,72,223
Morgan State6,6,Andre Horne Jr.,JR,G,Morgan State,MEAC,26,583,83,213,50,115,33,98,49,63,27,37,64,34,21,5,38,81,248
Morgan State7,7,Martez Cameron,FR,G,Morgan State,MEAC,31,560,22,91,15,72,7,19,23,39,15,32,47,66,22,0,46,49,74
Morgan State8,8,Clive Vaughan,SO,G,Morgan State,MEAC,31,331,44,113,23,46,21,67,10,20,12,29,41,7,4,0,19,35,119
Morgan State9,9,Antonio Gillespie,FR,G,Morgan State,MEAC,24,327,33,119,20,61,13,58,12,24,9,12,21,18,8,0,12,24,91
Morgan State10,10,Tyler Streeter,FR,G,Morgan State,MEAC,25,191,23,50,17,28,6,22,16,16,21,14,35,3,7,1,9,20,68
Morgan State11,11,Jamar Redmond,SO,G,Morgan State,MEAC,15,107,5,25,1,7,4,18,5,8,1,8,9,3,2,0,9,28,19
Morgan State12,12,Andrew Hampton,SR,F,Morgan State,MEAC,4,52,5,16,0,4,5,12,1,2,0,4,4,2,1,1,0,8,16
Mount St. Mary's1,1,Byron Ashe,JR,G,Mount St. Mary's,NEC,33,1030,166,412,113,242,53,170,70,97,31,118,149,56,42,16,58,92,455
Mount St. Mary's2,2,Junior Robinson,SO,G,Mount St. Mary's,NEC,33,952,135,351,85,205,50,146,94,112,13,47,60,102,38,0,83,77,414
Mount St. Mary's3,3,Gregory Graves,SR,F,Mount St. Mary's,NEC,33,892,104,272,83,202,21,70,80,121,61,122,183,25,30,22,54,82,309
Mount St. Mary's4,4,Charles Glover,SO,G,Mount St. Mary's,NEC,33,722,57,161,22,55,35,106,41,55,7,83,90,33,24,4,42,89,190
Mount St. Mary's5,5,Elijah Long,FR,G,Mount St. Mary's,NEC,30,687,63,185,50,146,13,39,30,48,10,66,76,66,32,3,47,47,169
Mount St. Mary's6,6,Will Miller,JR,F,Mount St. Mary's,NEC,33,650,56,173,7,19,49,154,13,15,4,59,63,13,8,0,8,22,174
Mount St. Mary's7,7,Taylor Danaher,SR,C,Mount St. Mary's,NEC,33,615,92,180,92,176,0,4,43,62,69,70,139,12,12,37,34,108,227
Mount St. Mary's8,8,Chris Wray,SO,F,Mount St. Mary's,NEC,30,505,80,143,80,142,0,1,15,45,70,53,123,17,32,32,27,61,175
Mount St. Mary's9,9,Khalid Nwandu,JR,G,Mount St. Mary's,NEC,28,426,29,62,29,60,0,2,25,39,17,42,59,36,30,2,32,56,83
Mount St. Mary's10,10,Troy Henderson,FR,F,Mount St. Mary's,NEC,19,121,5,19,1,3,4,16,2,3,3,4,7,0,0,3,4,14,16
Mount St. Mary's11,11,Liam McManimon,SR,G,Mount St. Mary's,NEC,13,28,1,8,0,3,1,5,3,4,2,2,4,1,0,0,1,4,6
Murray State1,1,Jeffery Moss,SR,F,Murray State,OVC,31,1106,146,336,66,143,80,193,69,88,28,97,125,63,23,3,40,70,441
Murray State2,2,Bryce Jones,JR,G,Murray State,OVC,31,989,118,303,81,193,37,110,122,140,19,104,123,131,38,14,86,96,395
Murray State3,3,Wayne Langston,SR,F,Murray State,OVC,31,927,163,258,163,258,0,0,92,132,83,105,188,42,24,11,46,111,418
Murray State4,4,Gee McGhee,JR,F,Murray State,OVC,31,927,83,197,54,118,29,79,84,123,47,99,146,72,31,8,44,79,279
Murray State5,5,Damarcus Croaker,JR,G,Murray State,OVC,29,825,113,242,89,168,24,74,28,54,36,95,131,46,18,7,59,59,278
Murray State6,6,Justin Seymour,JR,G,Murray State,OVC,30,710,77,190,33,73,44,117,16,22,10,79,89,48,27,6,36,73,214
Murray State7,7,Chad Culbreath,FR,G,Murray State,OVC,23,254,35,92,23,49,12,43,10,18,7,20,27,32,16,0,24,38,92
Murray State8,8,Brion Sanchious,FR,F,Murray State,OVC,18,247,14,26,14,26,0,0,4,10,24,28,52,7,5,11,12,38,32
Murray State9,9,Charles Brown,FR,F,Murray State,OVC,16,127,9,18,9,18,0,0,9,13,9,18,27,4,1,2,5,29,27
Murray State10,10,A.J. Patty,JR,F,Murray State,OVC,18,93,10,29,10,24,0,5,10,12,8,15,23,0,3,3,4,16,30
Murray State11,11,Terron Gilmore,SR,F,Murray State,OVC,6,20,2,3,2,3,0,0,0,1,1,3,4,0,0,1,0,8,4
NJIT1,1,Damon Lynn,JR,G,NJIT,Ind,31,1166,172,465,73,156,99,309,123,147,11,82,93,101,51,2,65,40,566
NJIT2,2,Ky Howard,SR,G,NJIT,Ind,30,953,124,244,103,191,21,53,119,156,30,111,141,134,32,4,90,85,388
NJIT3,3,Tim Coleman,JR,F,NJIT,Ind,31,850,144,306,103,202,41,104,95,120,37,180,217,71,45,25,65,101,424
NJIT4,4,Rob Ukawuba,JR,G,NJIT,Ind,29,602,71,172,54,112,17,60,58,82,23,70,93,49,19,4,33,63,217
NJIT5,5,Terrence Smith,JR,F,NJIT,Ind,24,506,79,140,79,140,0,0,15,34,43,60,103,20,9,7,29,62,173
NJIT6,6,Emmanuel Tselentakis,SR,G,NJIT,Ind,30,476,27,61,15,31,12,30,6,12,35,63,98,34,13,7,21,54,72
NJIT7,7,Chris Jenkins,SO,G,NJIT,Ind,25,447,64,155,11,22,53,133,4,9,1,20,21,9,11,0,14,30,185
NJIT8,8,Mohamed Bendary,FR,F,NJIT,Ind,30,375,39,61,39,61,0,0,10,19,39,62,101,19,5,12,23,79,88
NJIT9,9,Osa Izevbuwa,JR,G,NJIT,Ind,30,304,23,69,15,30,8,39,9,15,16,29,45,16,10,0,14,24,63
NJIT10,10,Vlad Shustov,SO,F,NJIT,Ind,21,262,26,55,25,52,1,3,3,5,12,31,43,10,2,10,22,49,56
NJIT11,11,Winfield Willis,SR,G,NJIT,Ind,9,248,30,71,18,37,12,34,21,22,9,19,28,24,8,1,14,18,93
NJIT12,12,Derek McKnight,FR,G,NJIT,Ind,8,17,1,4,1,4,0,0,2,4,1,1,2,0,0,0,1,3,4
NJIT13,13,Seth Callahan,FR,G,NJIT,Ind,5,16,4,4,2,2,2,2,0,0,0,1,1,0,1,0,1,1,10
Navy1,1,Tilman Dunbar,SR,G,Navy,Patriot,33,1033,120,292,98,238,22,54,125,172,16,76,92,127,33,1,82,73,387
Navy2,2,Shawn Anderson,SO,G,Navy,Patriot,33,1001,165,331,141,255,24,76,81,124,36,96,132,87,26,3,75,66,435
Navy3,3,Will Kelly,SR,F,Navy,Patriot,33,889,134,216,134,216,0,0,78,143,59,131,190,42,19,87,68,107,346
Navy4,4,Jace Hogan,SO,F,Navy,Patriot,31,714,112,243,112,242,0,1,76,104,51,99,150,19,10,9,34,69,300
Navy5,5,Tim Abruzzo,JR,G,Navy,Patriot,30,588,66,189,26,59,40,130,25,35,16,84,100,29,35,9,23,23,197
Navy6,6,Tom Lacey,SO,F,Navy,Patriot,33,583,48,83,48,83,0,0,53,92,54,84,138,21,18,2,40,75,149
Navy7,7,Kendall Knorr,SR,G,Navy,Patriot,32,446,37,103,20,40,17,63,5,5,10,50,60,35,20,1,18,47,96
Navy8,8,Edward Alade,JR,C,Navy,Patriot,33,393,46,75,46,75,0,0,5,19,39,45,84,15,7,11,21,50,97
Navy9,9,Bryce Dulin,SO,G,Navy,Patriot,31,328,21,68,13,31,8,37,19,32,14,31,45,21,5,0,20,48,69
Navy10,10,Zach Fong,JR,G,Navy,Patriot,27,273,29,89,5,18,24,71,11,13,4,22,26,12,5,1,7,24,93
Navy11,11,Nourse Fox,SO,G,Navy,Patriot,32,270,7,29,5,13,2,16,0,1,4,19,23,30,7,0,18,43,16
Navy12,12,James Hemphill,JR,F,Navy,Patriot,17,76,12,20,12,20,0,0,0,5,12,14,26,0,1,0,3,11,24
Navy13,13,Ryan Pearson,FR,G,Navy,Patriot,14,49,4,14,1,2,3,12,1,3,2,1,3,0,1,1,5,6,12
Navy14,14,Hasan Abdullah,FR,G,Navy,Patriot,9,40,2,11,2,4,0,7,0,0,0,1,1,8,1,0,3,6,4
Navy15,15,George Kiernan,FR,F,Navy,Patriot,2,5,1,2,1,1,0,1,0,0,0,1,1,0,0,0,0,0,2
Navy16,16,Nathan Messer,FR,G,Navy,Patriot,2,3,1,1,0,0,1,1,0,0,0,0,0,1,0,0,0,0,3
Nebraska1,1,Andrew White III,JR,G,Nebraska,Big Ten,34,1010,195,405,108,194,87,211,86,111,40,159,199,20,39,11,53,89,563
Nebraska2,2,Tai Webster,JR,G,Nebraska,Big Ten,34,941,126,266,105,206,21,60,71,96,27,113,140,66,46,12,72,74,344
Nebraska3,3,Shavon Shields,SR,F,Nebraska,Big Ten,30,921,181,385,153,308,28,77,113,147,39,114,153,80,38,10,72,55,503
Nebraska4,4,Benny Parker,SR,G,Nebraska,Big Ten,34,878,57,148,33,72,24,76,25,29,14,64,78,74,38,2,41,77,163
Nebraska5,5,Glynn Watson Jr.,FR,G,Nebraska,Big Ten,34,826,115,296,95,221,20,75,42,53,8,55,63,83,40,3,35,73,292
Nebraska6,6,Michael Jacobson,FR,F,Nebraska,Big Ten,34,623,52,120,49,104,3,16,52,67,64,82,146,17,19,28,20,81,159
Nebraska7,7,Jack McVeigh,FR,F,Nebraska,Big Ten,34,577,55,157,21,57,34,100,20,29,24,66,90,35,14,5,27,45,164
Nebraska8,8,Ed Morrow,FR,F,Nebraska,Big Ten,30,411,53,83,53,83,0,0,16,28,46,53,99,3,0,21,31,67,122
Nebraska9,9,Jake Hammond,SO,F,Nebraska,Big Ten,29,311,23,53,23,53,0,0,17,39,42,39,81,6,5,17,13,45,63
Nebraska10,10,Nick Fuller,SO,F,Nebraska,Big Ten,24,189,14,29,14,27,0,2,16,29,15,18,33,5,9,3,13,27,44
Nebraska11,11,Bakari Evelyn,FR,G,Nebraska,Big Ten,18,83,7,23,5,8,2,15,8,8,2,7,9,4,0,0,8,14,24
Nebraska12,12,Johnny Trueblood,FR,G,Nebraska,Big Ten,10,28,2,5,1,4,1,1,3,6,0,2,2,4,1,0,1,0,8
Nebraska13,13,Tanner Borchardt,FR,F,Nebraska,Big Ten,8,28,3,3,3,3,0,0,0,0,2,7,9,0,0,0,5,5,6
Nebraska-Omaha1,1,Devin Patterson,SR,G,Nebraska-Omaha,Summit,31,1010,173,406,121,254,52,152,143,180,10,65,75,97,57,0,83,78,541
Nebraska-Omaha2,2,Tra-Deon Hollins,JR,G,Nebraska-Omaha,Summit,31,998,132,276,107,191,25,85,100,134,35,111,146,187,125,13,93,81,389
Nebraska-Omaha3,3,Tre'Shawn Thurman,SO,F,Nebraska-Omaha,Summit,31,855,168,314,155,268,13,46,86,132,61,145,206,40,25,35,51,88,435
Nebraska-Omaha4,4,Jake White,SR,F,Nebraska-Omaha,Summit,31,806,191,335,171,295,20,40,135,166,71,124,195,10,10,7,48,93,537
Nebraska-Omaha5,5,Kyler Erickson,SR,G,Nebraska-Omaha,Summit,31,601,31,90,14,35,17,55,30,41,5,53,58,24,13,4,10,37,109
Nebraska-Omaha6,6,Tim Smallwood,SR,G,Nebraska-Omaha,Summit,31,504,58,157,21,50,37,107,13,19,11,52,63,18,18,3,25,58,166
Nebraska-Omaha7,7,Randy Reed,SR,G,Nebraska-Omaha,Summit,30,491,64,126,61,120,3,6,44,59,22,71,93,15,15,8,28,58,175
Nebraska-Omaha8,8,Zach Jackson,FR,G,Nebraska-Omaha,Summit,31,476,39,101,29,64,10,37,23,28,22,43,65,28,23,5,21,63,111
Nebraska-Omaha9,9,Daniel Meyer,SO,F,Nebraska-Omaha,Summit,31,255,35,66,35,65,0,1,12,26,23,24,47,7,3,8,16,32,82
Nebraska-Omaha10,10,JT Gibson,FR,G,Nebraska-Omaha,Summit,9,114,16,37,8,12,8,25,2,2,4,11,15,8,1,1,5,15,42
Nebraska-Omaha11,11,Zach Pirog,FR,C,Nebraska-Omaha,Summit,14,76,9,19,9,16,0,3,2,7,6,16,22,0,1,10,8,14,20
Nebraska-Omaha12,12,Devin Newsome,SO,G,Nebraska-Omaha,Summit,12,61,3,13,1,8,2,5,1,1,2,7,9,5,0,0,8,4,9
Nevada1,1,D.J. Fenner,JR,G,Nevada,MWC,32,1053,140,394,96,244,44,150,90,105,24,128,152,58,40,15,57,94,414
Nevada2,2,Tyron Criswell,SR,G,Nevada,MWC,32,947,140,277,131,240,9,37,104,148,74,122,196,62,35,21,63,91,393
Nevada3,3,Cameron Oliver,FR,F,Nevada,MWC,32,912,157,321,144,277,13,44,68,107,92,191,283,24,20,78,66,99,395
Nevada4,4,Lindsey Drew,FR,G,Nevada,MWC,31,869,51,152,34,87,17,65,35,55,26,111,137,77,49,26,58,92,154
Nevada5,5,Marqueze Coleman,SR,G,Nevada,MWC,29,864,137,334,113,250,24,84,162,212,22,105,127,99,39,5,77,81,460
Nevada6,6,Eric Cooper,SO,G,Nevada,MWC,32,798,99,293,51,128,48,165,60,72,17,55,72,27,24,2,32,63,306
Nevada7,7,Elijah Foster,SO,F,Nevada,MWC,30,469,36,71,36,71,0,0,16,25,29,72,101,21,7,9,22,66,88
Nevada8,8,AJ West,SR,C,Nevada,MWC,10,237,31,68,31,68,0,0,34,45,43,34,77,6,7,18,22,18,96
Nevada9,9,Kaileb Rodriguez,JR,F,Nevada,MWC,27,159,11,19,11,19,0,0,9,17,17,26,43,3,2,6,11,42,31
Nevada10,10,Juwan Anderson,FR,G,Nevada,MWC,22,120,2,8,2,5,0,3,2,4,4,5,9,11,7,0,5,19,6
Nevada11,11,Lucas Stivrins,SR,F,Nevada,MWC,9,62,11,24,4,8,7,16,4,7,10,9,19,0,1,2,2,15,33
Nevada12,12,David Cunningham,FR,G,Nevada,MWC,13,25,1,3,0,0,1,3,2,4,0,3,3,3,1,0,2,4,5
Nevada13,13,Justin Botteri,FR,F,Nevada,MWC,3,10,1,2,1,2,0,0,0,0,1,2,3,1,0,0,2,1,2
Nevada-Las Vegas1,1,Patrick McCaw,SO,G,Nevada-Las Vegas,MWC,33,1113,168,361,100,175,68,186,82,106,38,131,169,128,81,13,68,73,486
Nevada-Las Vegas2,2,Jerome Seagears,SR,G,Nevada-Las Vegas,MWC,31,915,102,248,57,117,45,131,69,86,16,74,90,126,39,3,59,76,318
Nevada-Las Vegas3,3,Ike Nwamu,SR,G,Nevada-Las Vegas,MWC,33,828,119,312,57,133,62,179,77,113,20,87,107,55,27,6,58,78,377
Nevada-Las Vegas4,4,Jordan Cornish,SO,G,Nevada-Las Vegas,MWC,33,714,68,193,37,90,31,103,38,64,9,75,84,50,16,1,47,58,205
Nevada-Las Vegas5,5,Stephen Zimmerman Jr.,FR,F,Nevada-Las Vegas,MWC,26,680,102,214,97,197,5,17,63,101,56,171,227,22,14,51,54,79,272
Nevada-Las Vegas6,6,Derrick Jones Jr.,FR,F,Nevada-Las Vegas,MWC,30,646,129,219,121,180,8,39,79,133,52,82,134,24,27,40,36,93,345
Nevada-Las Vegas7,7,Jalen Poyser,FR,G,Nevada-Las Vegas,MWC,33,534,58,155,37,96,21,59,40,61,18,50,68,37,18,1,36,50,177
Nevada-Las Vegas8,8,Ben Carter,JR,F,Nevada-Las Vegas,MWC,22,529,69,124,69,122,0,2,52,69,57,75,132,35,21,30,41,61,190
Nevada-Las Vegas9,9,Dwayne Morgan,SO,F,Nevada-Las Vegas,MWC,27,522,54,127,50,115,4,12,37,50,45,81,126,14,15,16,48,93,149
Nevada-Las Vegas10,10,Goodluck Okonoboh,SO,F,Nevada-Las Vegas,MWC,6,91,8,21,8,21,0,0,5,14,9,9,18,2,5,7,6,9,21
Nevada-Las Vegas11,11,Austin Starr,FR,G,Nevada-Las Vegas,MWC,13,85,4,19,0,0,4,19,4,6,2,1,3,2,2,0,2,15,16
Nevada-Las Vegas12,12,Barry Cheaney,SR,G,Nevada-Las Vegas,MWC,8,48,2,6,1,2,1,4,3,5,0,3,3,2,1,0,0,8,8
Nevada-Las Vegas13,13,Tyrell Green,JR,F,Nevada-Las Vegas,MWC,7,38,3,14,1,6,2,8,6,7,3,6,9,2,0,0,2,6,14
Nevada-Las Vegas14,14,Daquan Cook,JR,G,Nevada-Las Vegas,MWC,2,4,1,2,0,1,1,1,0,0,0,1,1,0,0,0,0,0,3
New Hampshire1,1,Jaleen Smith,JR,G,New Hampshire,AEC,28,964,114,279,78,179,36,100,102,114,39,113,152,95,28,12,59,69,366
New Hampshire2,2,Tanner Leissner,SO,F,New Hampshire,AEC,28,921,158,359,138,289,20,70,111,146,68,132,200,42,10,5,57,68,447
New Hampshire3,3,Joe Bramanti,JR,G,New Hampshire,AEC,28,834,39,116,27,72,12,44,32,56,20,81,101,76,20,3,48,89,122
New Hampshire4,4,Ronnel Jordan,SR,G,New Hampshire,AEC,31,810,111,257,75,148,36,109,28,52,25,93,118,38,14,7,38,52,286
New Hampshire5,5,Iba Camara,SO,F,New Hampshire,AEC,31,698,93,176,93,175,0,1,60,100,85,184,269,24,13,14,59,78,246
New Hampshire6,6,Daniel Dion,JR,G,New Hampshire,AEC,27,696,70,213,31,75,39,138,58,65,11,56,67,47,14,4,27,53,237
New Hampshire7,7,Jacoby Armstrong,JR,F,New Hampshire,AEC,26,629,110,239,104,219,6,20,66,96,44,90,134,15,10,5,40,85,292
New Hampshire8,8,Keon Burns,SO,G,New Hampshire,AEC,27,346,21,67,5,19,16,48,13,19,8,34,42,18,5,0,11,27,71
New Hampshire9,9,Pat McNamara,FR,G,New Hampshire,AEC,24,247,32,75,2,9,30,66,2,2,1,7,8,10,8,0,5,13,96
New Hampshire10,10,David Watkins,FR,F,New Hampshire,AEC,17,76,11,28,6,13,5,15,4,9,6,12,18,0,0,4,6,16,31
New Hampshire11,11,Andrew Dotson,FR,G,New Hampshire,AEC,6,29,3,15,2,9,1,6,2,5,1,0,1,2,1,0,1,1,9
New Mexico1,1,Tim Williams,JR,F,New Mexico,MWC,32,1078,215,356,215,356,0,0,109,163,65,172,237,33,19,39,48,67,539
New Mexico2,2,Elijah Brown,SO,G,New Mexico,MWC,32,1077,194,453,105,227,89,226,217,255,22,154,176,101,35,2,108,64,694
New Mexico3,3,Cullen Neal,SO,G,New Mexico,MWC,31,936,120,343,67,181,53,162,87,117,11,75,86,114,25,0,101,90,380
New Mexico4,4,Sam Logwood,SO,G,New Mexico,MWC,32,836,75,171,58,128,17,43,35,60,37,93,130,58,24,14,49,78,202
New Mexico5,5,Obij Aget,JR,C,New Mexico,MWC,32,723,89,139,89,139,0,0,34,48,67,115,182,11,7,38,44,98,212
New Mexico6,6,Xavier Adams,SO,G,New Mexico,MWC,32,446,50,102,46,78,4,24,42,63,33,49,82,32,16,8,34,88,146
New Mexico7,7,Joe Furstinger,SO,F,New Mexico,MWC,29,337,14,43,14,42,0,1,18,29,15,41,56,13,15,19,16,55,46
New Mexico8,8,Tim Jacobs,SR,G,New Mexico,MWC,26,252,9,19,5,14,4,5,6,9,3,37,40,39,10,1,18,28,28
New Mexico9,9,Jordan Hunter,FR,G,New Mexico,MWC,28,251,23,53,13,29,10,24,7,10,3,23,26,31,14,0,26,22,63
New Mexico10,10,Dane Kuiper,FR,G,New Mexico,MWC,25,207,12,37,6,19,6,18,7,9,3,23,26,20,6,8,9,22,37
New Mexico11,11,Anthony Mathis,FR,G,New Mexico,MWC,25,165,17,44,5,10,12,34,11,12,2,11,13,9,7,0,12,25,57
New Mexico12,12,Nikola Scekic,FR,C,New Mexico,MWC,11,75,8,15,8,15,0,0,1,1,3,5,8,1,1,1,7,15,17
New Mexico13,13,Michael Nesbitt,SR,F,New Mexico,MWC,5,8,2,4,2,3,0,1,0,1,2,1,3,0,0,0,0,0,4
New Mexico14,14,Connor Joy,SR,G,New Mexico,MWC,3,4,1,1,0,0,1,1,0,0,0,0,0,0,0,0,2,1,3
New Mexico State1,1,Pascal Siakam,SO,F,New Mexico State,WAC,33,1136,265,486,262,471,3,15,136,201,126,255,381,56,30,74,65,91,669
New Mexico State2,2,Ian Baker,JR,G,New Mexico State,WAC,33,1078,151,352,83,176,68,176,87,107,20,132,152,118,37,4,74,47,457
New Mexico State3,3,Jalyn Pennie,SO,G,New Mexico State,WAC,33,891,81,197,47,98,34,99,20,33,43,98,141,41,15,18,42,56,216
New Mexico State4,4,Matt Taylor,SO,G,New Mexico State,WAC,33,848,66,174,56,135,10,39,38,68,30,90,120,85,15,19,79,71,180
New Mexico State5,5,Johnathon Wilkins,SO,F,New Mexico State,WAC,30,688,80,147,78,143,2,4,28,45,45,62,107,36,6,14,40,67,190
New Mexico State6,6,Tanveer Bhullar,SO,C,New Mexico State,WAC,33,598,71,118,71,117,0,1,47,83,66,103,169,21,4,14,31,57,189
New Mexico State7,7,Braxton Huggins,SO,G,New Mexico State,WAC,31,438,57,151,27,60,30,91,38,45,9,53,62,32,9,5,35,32,182
New Mexico State8,8,Rashawn Browne,FR,G,New Mexico State,WAC,33,399,20,61,11,29,9,32,26,38,2,40,42,36,9,1,26,33,75
New Mexico State9,9,Sidy Ndir,FR,G,New Mexico State,WAC,27,293,31,80,20,39,11,41,27,36,6,34,40,20,3,4,20,30,100
New Mexico State10,10,Eli Chuha,FR,F,New Mexico State,WAC,21,155,26,46,25,40,1,6,11,18,15,29,44,9,4,3,21,21,64
New Mexico State11,11,Rene Esparza,JR,G,New Mexico State,WAC,17,113,9,31,4,15,5,16,4,9,1,9,10,9,2,2,10,4,27
New Mexico State12,12,Jose Campo,FR,F,New Mexico State,WAC,12,48,5,7,5,7,0,0,1,4,5,5,10,2,1,0,3,11,11
New Mexico State13,13,Harold Givens,FR,F,New Mexico State,WAC,5,15,2,5,2,5,0,0,4,4,3,0,3,0,0,0,0,1,8
New Orleans1,1,Christavious Gill,JR,G,New Orleans,Southland,30,908,140,372,76,187,64,185,100,120,26,48,74,83,57,3,51,55,444
New Orleans2,2,Nate Frye,JR,G,New Orleans,Southland,30,844,87,220,66,163,21,57,108,146,39,64,103,104,39,3,67,75,303
New Orleans3,3,Erik Thomas,JR,F,New Orleans,Southland,29,662,124,223,124,221,0,2,93,133,77,122,199,44,26,13,46,59,341
New Orleans4,4,Kevin Hill,SR,F,New Orleans,Southland,29,618,105,216,105,216,0,0,77,110,63,114,177,21,14,18,58,61,287
New Orleans5,5,Travin Thibodeaux,SO,F,New Orleans,Southland,30,603,71,140,71,140,0,0,35,78,58,114,172,33,32,14,57,101,177
New Orleans6,6,Cameron Reed,FR,G,New Orleans,Southland,29,571,54,160,10,34,44,126,18,22,9,26,35,26,11,6,25,52,170
New Orleans7,7,Michael Zeno,SO,G,New Orleans,Southland,29,543,82,186,82,184,0,2,53,99,59,79,138,25,28,17,49,67,217
New Orleans8,8,Tevin Broyles,JR,G,New Orleans,Southland,22,496,52,141,43,112,9,29,49,69,12,42,54,34,26,1,54,64,162
New Orleans9,9,Coleman Edwards,FR,G,New Orleans,Southland,29,378,21,77,8,31,13,46,10,16,2,28,30,25,11,0,21,57,65
New Orleans10,10,Danny Cohen,FR,G,New Orleans,Southland,26,200,14,45,4,19,10,26,8,9,9,14,23,5,1,0,8,16,46
New Orleans11,11,Matthew Jiles,SO,G,New Orleans,Southland,18,73,4,14,3,7,1,7,2,2,7,8,15,3,6,0,6,11,11
New Orleans12,12,Lamine Mbodj,JR,F,New Orleans,Southland,16,64,4,15,4,15,0,0,3,4,7,14,21,2,0,0,4,11,11
New Orleans13,13,Travis Avery,SR,C,New Orleans,Southland,21,62,5,11,5,11,0,0,5,8,2,7,9,3,1,1,2,11,15
Niagara1,1,Emile Blackman,JR,G,Niagara,MAAC,32,1067,185,426,143,282,42,144,94,117,38,74,112,44,29,6,84,88,506
Niagara2,2,Matt Scott,SO,G,Niagara,MAAC,30,992,145,358,111,240,34,118,135,176,61,152,213,76,39,10,96,85,459
Niagara3,3,Marvin Prochet,FR,F,Niagara,MAAC,32,856,78,202,59,143,19,59,59,90,53,121,174,28,20,25,42,67,234
Niagara4,4,Cameron Fowler,JR,G,Niagara,MAAC,30,692,40,124,29,75,11,49,13,27,22,61,83,83,23,3,53,67,104
Niagara5,5,Justin Satchell,JR,F,Niagara,MAAC,32,613,87,207,65,130,22,77,17,26,37,88,125,20,17,7,41,53,213
Niagara6,6,Karonn Davis,SO,G,Niagara,MAAC,28,573,38,143,15,68,23,75,21,31,15,45,60,54,12,1,25,49,120
Niagara7,7,Chris Barton,FR,G,Niagara,MAAC,32,557,41,116,28,61,13,55,38,48,12,41,53,25,5,0,29,59,133
Niagara8,8,Dominic Robb,FR,F,Niagara,MAAC,32,550,78,140,78,140,0,0,30,45,33,70,103,7,6,34,22,72,186
Niagara9,9,Maurice Taylor,JR,F,Niagara,MAAC,32,378,27,60,25,55,2,5,15,34,35,59,94,4,9,8,33,49,71
Niagara10,10,Alioune Tew,SO,F,Niagara,MAAC,25,163,15,32,15,32,0,0,9,26,14,19,33,3,3,8,19,35,39
Niagara11,11,Romero Collier,FR,G,Niagara,MAAC,6,36,1,12,1,6,0,6,0,0,2,0,2,3,1,1,3,2,2
Nicholls State1,1,T.J. Carpenter,SR,G,Nicholls State,Southland,33,961,125,350,64,149,61,201,84,117,31,145,176,83,32,7,93,102,395
Nicholls State2,2,Schane Rillieux,SR,G,Nicholls State,Southland,34,912,63,159,53,125,10,34,50,105,8,59,67,96,49,3,75,84,186
Nicholls State3,3,Ja'Dante' Frye,JR,F,Nicholls State,Southland,34,885,144,305,119,234,25,71,112,139,31,126,157,39,26,11,70,54,425
Nicholls State4,4,Liam Thomas,JR,F,Nicholls State,Southland,34,839,113,210,101,165,12,45,60,101,58,120,178,70,21,85,76,109,298
Nicholls State5,5,Johnathan Bell,JR,G,Nicholls State,Southland,34,824,100,264,69,166,31,98,56,79,24,97,121,33,31,12,43,57,287
Nicholls State6,6,Luka Kamber,JR,F,Nicholls State,Southland,34,590,46,150,10,23,36,127,13,15,20,42,62,23,12,3,25,72,141
Nicholls State7,7,Tre O'Neal,JR,G,Nicholls State,Southland,34,526,25,74,15,41,10,33,30,49,10,27,37,43,20,1,47,31,90
Nicholls State8,8,Adam Ward,JR,F,Nicholls State,Southland,31,489,68,123,68,123,0,0,38,74,49,63,112,9,15,32,28,64,174
Nicholls State9,9,KC Caudill,SR,C,Nicholls State,Southland,34,381,60,123,59,114,1,9,51,68,27,36,63,19,3,7,41,81,172
Nicholls State10,10,Quinton Thomas,SO,G,Nicholls State,Southland,29,344,37,93,14,31,23,62,14,27,8,38,46,14,17,2,22,23,111
Nicholls State11,11,Marquis Nelson,SO,G,Nicholls State,Southland,17,84,5,19,2,8,3,11,0,0,2,8,10,2,3,0,6,7,13
Nicholls State12,12,Robert Bissant,SO,G,Nicholls State,Southland,4,3,1,3,1,2,0,1,1,2,0,1,1,0,0,0,0,0,3
Norfolk State1,1,Jeff Short,SR,G,Norfolk State,MEAC,32,937,152,366,86,183,66,183,130,159,14,105,119,84,27,4,70,84,500
Norfolk State2,2,D'Shon Taylor,SR,G,Norfolk State,MEAC,32,912,144,317,100,198,44,119,97,127,55,114,169,49,37,19,61,83,429
Norfolk State3,3,Jordan Butler,SO,F,Norfolk State,MEAC,33,890,90,166,90,166,0,0,68,94,78,143,221,29,12,71,40,106,248
Norfolk State4,4,Zaynah Robinson,SO,G,Norfolk State,MEAC,33,870,64,185,31,102,33,83,44,51,3,67,70,95,41,2,26,56,205
Norfolk State5,5,Charles Oliver,SR,G,Norfolk State,MEAC,33,805,114,284,55,112,59,172,117,142,19,53,72,33,10,2,44,80,404
Norfolk State6,6,Alex Long,FR,F,Norfolk State,MEAC,33,551,63,143,63,139,0,4,40,57,43,79,122,15,11,34,41,80,166
Norfolk State7,7,Preston Bungei,JR,G,Norfolk State,MEAC,33,529,60,129,59,121,1,8,54,75,38,66,104,28,13,31,42,75,175
Norfolk State8,8,Jonathan Wade,JR,G,Norfolk State,MEAC,32,504,61,149,42,94,19,55,49,57,32,51,83,19,13,2,29,54,190
Norfolk State9,9,Brian Kelley,JR,G,Norfolk State,MEAC,28,318,18,52,17,39,1,13,11,13,6,18,24,31,12,3,28,42,48
Norfolk State10,10,Devonte Banner,SO,G,Norfolk State,MEAC,28,210,22,51,8,16,14,35,3,13,8,20,28,17,8,0,9,23,61
Norfolk State11,11,Moses Toriola,FR,F,Norfolk State,MEAC,22,101,1,9,1,9,0,0,2,5,5,5,10,0,2,1,6,18,4
Norfolk State12,12,Justin Peebles-Jennings,SO,G,Norfolk State,MEAC,13,23,3,7,0,0,3,7,1,2,0,2,2,1,1,0,1,2,10
North Carolina1,1,Joel Berry,SO,G,North Carolina,ACC,34,1030,144,332,85,181,59,151,82,95,19,90,109,120,51,9,53,76,429
North Carolina2,2,Justin Jackson,SO,F,North Carolina,ACC,34,962,167,357,141,256,26,101,50,77,60,72,132,98,21,14,37,62,410
North Carolina3,3,Brice Johnson,SR,F,North Carolina,ACC,34,929,226,368,226,368,0,0,112,145,99,261,360,51,39,43,61,91,564
North Carolina4,4,Marcus Paige,SR,G,North Carolina,ACC,28,885,112,285,58,118,54,167,60,78,12,57,69,104,33,14,34,42,338
North Carolina5,5,Theo Pinson,SO,G,North Carolina,ACC,34,646,50,130,33,71,17,59,42,61,36,76,112,103,19,10,44,55,159
North Carolina6,6,Isaiah Hicks,JR,F,North Carolina,ACC,34,620,114,188,114,188,0,0,84,114,70,91,161,24,17,18,39,97,312
North Carolina7,7,Kennedy Meeks,JR,F,North Carolina,ACC,27,566,111,197,111,197,0,0,32,49,58,102,160,31,24,32,36,60,254
North Carolina8,8,Nate Britt,JR,G,North Carolina,ACC,33,519,65,168,41,99,24,69,38,48,10,34,44,64,22,0,30,38,192
North Carolina9,9,Joel James,SR,F,North Carolina,ACC,31,267,30,67,30,67,0,0,10,20,33,46,79,0,1,6,15,42,70
North Carolina10,10,Luke Maye,FR,F,North Carolina,ACC,29,175,16,41,14,34,2,7,5,12,25,30,55,7,3,3,10,26,39
North Carolina11,11,Kenny Williams,FR,G,North Carolina,ACC,25,114,8,22,7,9,1,13,4,4,3,6,9,6,3,0,1,10,21
North Carolina12,12,Stilman White,JR,G,North Carolina,ACC,14,26,1,8,1,6,0,2,0,0,4,2,6,2,0,0,1,5,2
North Carolina13,13,Spenser Dalton,SR,G,North Carolina,ACC,14,17,1,9,1,2,0,7,0,0,1,1,2,0,0,0,1,1,2
North Carolina14,14,Justin Coleman,SR,G,North Carolina,ACC,11,14,1,4,1,2,0,2,1,2,0,1,1,1,0,0,1,1,3
North Carolina15,15,Kanler Coker,JR,G,North Carolina,ACC,11,14,1,4,1,2,0,2,0,0,1,6,7,1,0,0,2,2,2
North Carolina A&T1,1,Ahmad Abdullah,SR,G,North Carolina A&T,MEAC,32,1122,100,263,62,166,38,97,69,87,19,84,103,109,18,1,59,63,307
North Carolina A&T2,2,Sam Hunt,SO,G,North Carolina A&T,MEAC,29,967,134,345,68,150,66,195,113,125,8,51,59,61,20,1,69,82,447
North Carolina A&T3,3,Bruce Beckford,SR,F,North Carolina A&T,MEAC,29,878,125,296,96,216,29,80,101,133,47,152,199,29,20,11,79,95,380
North Carolina A&T4,4,Ede Egharevba,SR,F,North Carolina A&T,MEAC,32,572,88,204,63,126,25,78,26,44,33,82,115,22,26,9,37,79,227
North Carolina A&T5,5,Denzel Keyes,JR,G,North Carolina A&T,MEAC,17,552,51,113,45,86,6,27,28,47,62,66,128,18,15,5,23,45,136
North Carolina A&T6,6,Steven Burrough,JR,C,North Carolina A&T,MEAC,28,529,51,107,51,107,0,0,34,63,31,60,91,12,8,31,25,77,136
North Carolina A&T7,7,Joshea Singleton,SR,F,North Carolina A&T,MEAC,16,390,47,121,34,78,13,43,34,48,24,34,58,15,8,6,30,36,141
North Carolina A&T8,8,Khary Doby,JR,F,North Carolina A&T,MEAC,27,282,39,92,31,63,8,29,6,12,11,33,44,5,2,3,12,44,92
North Carolina A&T9,9,James Whitaker,SO,G,North Carolina A&T,MEAC,28,268,38,85,33,62,5,23,31,38,16,27,43,11,11,3,22,44,112
North Carolina A&T10,10,Nick Reese,SO,F,North Carolina A&T,MEAC,25,240,22,54,20,47,2,7,7,12,8,30,38,12,8,1,15,37,53
North Carolina A&T11,11,Austin Williams,SO,G,North Carolina A&T,MEAC,26,188,12,42,11,30,1,12,13,27,4,17,21,21,17,0,24,32,38
North Carolina A&T12,12,Jamin Lackey,SO,F,North Carolina A&T,MEAC,18,169,17,31,17,31,0,0,0,4,11,29,40,7,0,4,14,29,34
North Carolina A&T13,13,Arturs Bremers,SR,G,North Carolina A&T,MEAC,22,118,4,22,0,1,4,21,0,0,3,11,14,6,0,0,4,12,12
North Carolina A&T14,14,Deion James,FR,F,North Carolina A&T,MEAC,21,115,8,27,8,23,0,4,11,25,12,19,31,9,6,2,6,26,27
North Carolina A&T15,15,Mike Owona,JR,C,North Carolina A&T,MEAC,12,63,3,8,3,8,0,0,4,7,7,8,15,2,2,0,7,5,10
North Carolina A&T16,16,Martin Jones,FR,F,North Carolina A&T,MEAC,10,48,5,20,3,4,2,16,0,0,1,4,5,0,1,0,0,8,12
North Carolina A&T17,17,Julien Johnson,SR,F,North Carolina A&T,MEAC,5,26,1,6,1,5,0,1,3,3,3,2,5,0,0,0,2,4,5
North Carolina Central1,1,Dante Holmes,SR,G,North Carolina Central,MEAC,29,975,151,374,77,177,74,197,73,106,28,113,141,52,29,2,60,98,449
North Carolina Central2,2,Jeremiah Ingram,SR,G,North Carolina Central,MEAC,32,875,122,264,104,218,18,46,73,124,60,138,198,32,17,15,81,119,335
North Carolina Central3,3,Dajuan Graf,JR,G,North Carolina Central,MEAC,29,844,84,187,71,142,13,45,46,64,11,77,88,115,27,1,67,56,227
North Carolina Central4,4,Rashaun Madison,SR,G,North Carolina Central,MEAC,31,728,79,196,22,46,57,150,10,16,9,37,46,34,33,0,20,44,225
North Carolina Central5,5,Patrick Cole,JR,G,North Carolina Central,MEAC,24,728,103,269,76,183,27,86,112,151,20,87,107,77,20,2,67,72,345
North Carolina Central6,6,Kyle Benton,JR,F,North Carolina Central,MEAC,31,720,88,154,88,152,0,2,59,94,96,100,196,8,15,20,31,71,235
North Carolina Central7,7,Enoch Hood,SR,F,North Carolina Central,MEAC,30,369,34,54,34,54,0,0,17,26,33,65,98,2,8,6,12,58,85
North Carolina Central8,8,C.J. Wiggins,FR,G,North Carolina Central,MEAC,23,333,35,91,32,85,3,6,22,36,5,21,26,51,3,0,22,17,95
North Carolina Central9,9,Jamal Ferguson,JR,G,North Carolina Central,MEAC,17,281,33,79,32,77,1,2,8,14,13,19,32,13,8,3,16,30,75
North Carolina Central10,10,Jay Copeland,SR,F,North Carolina Central,MEAC,11,232,22,38,22,38,0,0,17,26,25,28,53,1,11,3,21,35,61
North Carolina Central11,11,A.J. Lynch,JR,G,North Carolina Central,MEAC,7,102,5,32,3,16,2,16,5,8,6,10,16,10,6,1,8,7,17
North Carolina Central12,12,Jeremiah Worthem,JR,F,North Carolina Central,MEAC,10,92,9,20,9,20,0,0,13,18,9,17,26,3,3,0,6,9,31
North Carolina Central13,13,Nate Allen,FR,G,North Carolina Central,MEAC,16,81,9,35,4,11,5,24,0,4,3,4,7,2,2,0,5,11,23
North Carolina Central14,14,Marius McAllister,SO,G,North Carolina Central,MEAC,15,61,4,9,4,8,0,1,5,8,6,6,12,4,5,1,3,7,13
North Carolina Central15,15,Kevin Crawford,JR,G,North Carolina Central,MEAC,7,15,2,5,2,4,0,1,2,2,0,0,0,3,1,0,2,1,6
North Carolina State1,1,Anthony Barber,JR,G,North Carolina State,ACC,33,1278,248,572,205,453,43,119,237,274,21,130,151,147,21,2,85,71,776
North Carolina State2,2,Maverick Rowan,FR,G,North Carolina State,ACC,33,1102,140,389,59,148,81,241,65,85,29,73,102,23,15,2,49,73,426
North Carolina State3,3,Caleb Martin,SO,F,North Carolina State,ACC,33,1001,128,329,49,110,79,219,44,66,31,123,154,47,30,19,50,75,379
North Carolina State4,4,Abdul-Malik Abu,SO,F,North Carolina State,ACC,33,934,165,337,165,337,0,0,97,154,118,171,289,42,12,23,57,88,427
North Carolina State5,5,Cody Martin,SO,G,North Carolina State,ACC,33,855,78,167,75,160,3,7,40,67,57,87,144,75,40,14,46,69,199
North Carolina State6,6,BeeJay Anya,JR,F,North Carolina State,ACC,33,771,61,106,61,106,0,0,34,79,65,110,175,16,17,73,36,108,156
North Carolina State7,7,Lennard Freeman,JR,F,North Carolina State,ACC,33,639,41,78,41,78,0,0,25,50,67,99,166,33,12,7,25,61,107
North Carolina State8,8,Shaun Kirk,FR,G,North Carolina State,ACC,14,57,4,13,3,7,1,6,1,2,2,6,8,0,2,1,5,12,10
North Carolina State9,9,Chris Corchiani,SO,G,North Carolina State,ACC,2,2,1,1,1,1,0,0,0,0,0,0,0,0,0,0,0,0,2
North Carolina-Asheville1,1,Kevin Vannatta,SO,G,North Carolina-Asheville,Big South,33,1122,124,242,88,147,36,95,103,130,23,115,138,89,41,3,57,59,387
North Carolina-Asheville2,2,Dwayne Sutton,FR,G,North Carolina-Asheville,Big South,33,1000,128,269,106,202,22,67,119,189,77,181,258,42,52,23,54,87,397
North Carolina-Asheville3,3,Ahmad Thomas,SO,G,North Carolina-Asheville,Big South,33,922,154,306,145,278,9,28,53,81,51,163,214,63,69,5,68,92,370
North Carolina-Asheville4,4,Dylan Smith,FR,G,North Carolina-Asheville,Big South,33,896,130,353,53,128,77,225,109,132,13,77,90,58,34,11,84,80,446
North Carolina-Asheville5,5,Sam Hughes,SR,F,North Carolina-Asheville,Big South,33,874,136,270,129,252,7,18,82,113,56,92,148,40,44,44,58,88,361
North Carolina-Asheville6,6,Will Weeks,JR,F,North Carolina-Asheville,Big South,32,792,91,174,91,174,0,0,38,74,53,83,136,58,37,4,40,59,220
North Carolina-Asheville7,7,David Robertson,JR,G,North Carolina-Asheville,Big South,15,322,26,93,14,37,12,56,10,13,7,15,22,25,2,1,12,19,74
North Carolina-Asheville8,8,Trae Bryant,FR,G,North Carolina-Asheville,Big South,21,232,17,59,9,23,8,36,8,10,4,24,28,13,8,3,20,21,50
North Carolina-Asheville9,9,Raekwon Miller,SO,G,North Carolina-Asheville,Big South,17,214,27,73,9,18,18,55,15,25,6,14,20,16,15,2,12,24,87
North Carolina-Asheville10,10,John Cannon,SR,C,North Carolina-Asheville,Big South,16,105,24,40,24,38,0,2,8,14,10,16,26,2,2,10,6,14,56
North Carolina-Asheville11,11,Alec Wnuk,SO,F,North Carolina-Asheville,Big South,18,104,12,20,11,16,1,4,2,7,7,17,24,3,1,2,9,18,27
North Carolina-Asheville12,12,Giacomo Zilli,JR,F,North Carolina-Asheville,Big South,13,68,8,17,8,17,0,0,5,7,3,8,11,2,2,2,8,14,21
North Carolina-Greensboro1,1,Diante Baldwin,JR,G,North Carolina-Greensboro,Southern,32,1059,132,321,117,262,15,59,84,128,51,108,159,162,48,11,73,83,363
North Carolina-Greensboro2,2,Kayel Locke,SR,F,North Carolina-Greensboro,Southern,32,972,161,351,133,262,28,89,59,100,51,126,177,54,18,3,64,69,409
North Carolina-Greensboro3,3,Francis Alonso,FR,G,North Carolina-Greensboro,Southern,32,902,130,288,48,84,82,204,76,89,7,47,54,61,18,5,65,67,418
North Carolina-Greensboro4,4,Marvin Smith,SO,F,North Carolina-Greensboro,Southern,32,850,103,285,52,125,51,160,45,67,38,134,172,20,36,13,36,101,302
North Carolina-Greensboro5,5,RJ White,JR,C,North Carolina-Greensboro,Southern,31,847,156,253,149,227,7,26,57,89,64,154,218,33,22,29,53,104,376
North Carolina-Greensboro6,6,Asad Lamot,SR,G,North Carolina-Greensboro,Southern,32,726,53,124,14,31,39,93,17,21,9,48,57,19,16,3,22,79,162
North Carolina-Greensboro7,7,Demetrius Troy,FR,G,North Carolina-Greensboro,Southern,25,480,52,138,23,67,29,71,17,23,9,42,51,60,26,2,36,50,150
North Carolina-Greensboro8,8,Lloyd Burgess,FR,C,North Carolina-Greensboro,Southern,29,249,15,29,15,29,0,0,10,23,24,38,62,5,2,7,8,51,40
North Carolina-Greensboro9,9,Clay Byrd,JR,G,North Carolina-Greensboro,Southern,6,147,16,36,0,0,16,36,2,2,0,16,16,2,2,0,6,12,50
North Carolina-Greensboro10,10,Jordy Kuiper,JR,F,North Carolina-Greensboro,Southern,8,99,10,20,10,18,0,2,2,3,9,11,20,3,4,0,5,16,22
North Carolina-Greensboro11,11,Garrett Collins,SO,G,North Carolina-Greensboro,Southern,15,88,7,15,0,1,7,14,6,6,4,14,18,2,1,3,2,5,27
North Carolina-Greensboro12,12,Michael Adams,SR,G,North Carolina-Greensboro,Southern,10,18,3,6,1,1,2,5,2,2,2,1,3,2,0,1,1,1,10
North Carolina-Greensboro13,13,Jelani Mofford,FR,F,North Carolina-Greensboro,Southern,6,8,2,3,2,3,0,0,0,0,0,1,1,1,1,0,0,1,4
North Carolina-Wilmington1,1,Chris Flemmings,JR,G,North Carolina-Wilmington,CAA,32,1013,173,337,118,187,55,150,114,141,43,147,190,52,43,22,42,64,515
North Carolina-Wilmington2,2,Denzel Ingram,JR,G,North Carolina-Wilmington,CAA,31,1005,124,345,54,153,70,192,71,87,14,55,69,105,46,1,58,69,389
North Carolina-Wilmington3,3,Craig Ponder,SR,G,North Carolina-Wilmington,CAA,32,858,125,286,88,182,37,104,68,100,13,86,99,72,33,6,50,93,355
North Carolina-Wilmington4,4,Jordon Talley,SO,G,North Carolina-Wilmington,CAA,31,771,86,221,72,158,14,63,81,110,29,74,103,125,31,0,45,91,267
North Carolina-Wilmington5,5,C.J. Bryce,FR,G,North Carolina-Wilmington,CAA,32,733,118,223,105,193,13,30,68,107,37,92,129,23,31,2,55,86,317
North Carolina-Wilmington6,6,Marcus Bryan,SO,F,North Carolina-Wilmington,CAA,31,505,55,125,54,124,1,1,34,59,47,84,131,7,10,35,12,81,145
North Carolina-Wilmington7,7,Dylan Sherwood,SR,F,North Carolina-Wilmington,CAA,31,380,49,113,29,42,20,71,11,15,26,46,72,12,12,8,17,42,129
North Carolina-Wilmington8,8,C.J. Gettys,JR,C,North Carolina-Wilmington,CAA,23,362,46,89,46,89,0,0,33,44,44,74,118,11,3,32,21,69,125
North Carolina-Wilmington9,9,Devontae Cacok,FR,F,North Carolina-Wilmington,CAA,28,257,42,65,42,65,0,0,11,26,30,52,82,2,11,6,12,53,95
North Carolina-Wilmington10,10,Chuck Ogbodo,JR,C,North Carolina-Wilmington,CAA,19,213,30,47,30,47,0,0,6,15,27,36,63,1,4,23,21,52,66
North Carolina-Wilmington11,11,Mark Matthews,FR,G,North Carolina-Wilmington,CAA,23,204,28,68,20,40,8,28,12,17,12,25,37,13,10,1,11,14,76
North Carolina-Wilmington12,12,Trey Grundy,FR,F,North Carolina-Wilmington,CAA,17,123,16,38,15,28,1,10,9,14,9,11,20,4,5,3,9,29,42
North Carolina-Wilmington13,13,Kevin Hickson,SR,F,North Carolina-Wilmington,CAA,10,34,4,8,4,8,0,0,0,2,1,3,4,0,2,1,2,14,8
North Carolina-Wilmington14,14,Nick Powell,SO,G,North Carolina-Wilmington,CAA,10,17,2,6,2,4,0,2,2,4,0,0,0,1,0,0,3,3,6
North Dakota1,1,Quinton Hooker,JR,G,North Dakota,Big Sky,31,1096,208,423,158,293,50,130,161,189,36,118,154,112,58,8,57,70,627
North Dakota2,2,Drick Bernstine,SO,F,North Dakota,Big Sky,32,956,131,264,130,262,1,2,50,103,58,229,287,70,35,20,77,108,313
North Dakota3,3,Geno Crandall,FR,G,North Dakota,Big Sky,30,894,106,255,83,179,23,76,77,105,18,105,123,121,59,8,91,103,312
North Dakota4,4,Adam McDermott,FR,G,North Dakota,Big Sky,31,698,63,154,10,24,53,130,25,29,14,60,74,15,19,0,14,44,204
North Dakota5,5,Corey Baldwin,JR,G,North Dakota,Big Sky,32,679,83,206,32,69,51,137,31,50,22,86,108,36,32,5,31,56,248
North Dakota6,6,Conner Avants,FR,F,North Dakota,Big Sky,32,632,81,163,73,145,8,18,55,80,34,71,105,9,17,8,38,97,225
North Dakota7,7,Cortez Seales,FR,G,North Dakota,Big Sky,29,588,85,183,82,160,3,23,35,57,20,40,60,35,15,10,26,28,208
North Dakota8,8,Carson Shanks,SO,C,North Dakota,Big Sky,30,470,64,132,64,128,0,4,34,63,23,76,99,16,5,27,57,103,162
North Dakota9,9,Dustin Hobaugh,SR,G,North Dakota,Big Sky,26,175,7,20,7,16,0,4,15,23,11,25,36,3,4,0,10,23,29
North Dakota10,10,Josh Collins,FR,F,North Dakota,Big Sky,22,141,11,33,10,26,1,7,6,15,6,15,21,3,4,1,5,14,29
North Dakota11,11,Bryce Cashman,SO,C,North Dakota,Big Sky,10,86,6,13,6,13,0,0,5,9,8,10,18,0,2,3,7,24,17
North Dakota12,12,Shane Benton,SR,G,North Dakota,Big Sky,9,28,1,7,1,6,0,1,4,5,0,3,3,1,0,0,0,2,6
North Dakota13,13,Thomas Blake,JR,G,North Dakota,Big Sky,8,22,2,6,1,2,1,4,0,2,1,2,3,2,1,0,3,3,5
North Dakota14,14,James Richman,FR,F,North Dakota,Big Sky,3,10,1,3,1,3,0,0,1,2,1,1,2,0,0,0,1,0,3
North Dakota State1,1,A.J. Jacobson,SO,G,North Dakota State,Summit,33,1133,138,316,86,166,52,150,92,118,17,113,130,49,18,14,41,87,420
North Dakota State2,2,Khy Kabellis,FR,G,North Dakota State,Summit,32,972,92,225,56,115,36,110,57,81,13,86,99,72,22,5,49,49,277
North Dakota State3,3,Paul Miller,SO,G,North Dakota State,Summit,26,880,133,324,66,162,67,162,66,85,11,114,125,46,22,7,54,51,399
North Dakota State4,4,Kory Brown,SR,G,North Dakota State,Summit,27,786,104,213,90,167,14,46,58,77,40,135,175,67,36,26,54,82,280
North Dakota State5,5,Carlin Dupree,JR,G,North Dakota State,Summit,27,747,85,186,76,154,9,32,42,71,16,72,88,55,40,2,52,46,221
North Dakota State6,6,Dexter Werner,JR,F,North Dakota State,Summit,33,730,104,209,104,208,0,1,69,116,83,137,220,26,25,31,33,71,277
North Dakota State7,7,Malik Clements,SO,G,North Dakota State,Summit,30,490,69,191,39,88,30,103,22,36,15,52,67,13,14,1,27,27,190
North Dakota State8,8,Chris Kading,SR,F,North Dakota State,Summit,31,455,41,76,35,52,6,24,11,22,40,50,90,4,9,19,7,53,99
North Dakota State9,9,Dylan Miller,FR,F,North Dakota State,Summit,31,288,41,77,41,76,0,1,3,7,25,34,59,9,8,11,11,33,85
North Dakota State10,10,Brian Ishola,SO,G,North Dakota State,Summit,19,95,5,11,5,10,0,1,0,0,5,9,14,3,3,1,6,15,10
North Dakota State11,11,Spencer Eliason,FR,F,North Dakota State,Summit,11,45,5,9,5,9,0,0,2,4,9,6,15,3,0,0,2,9,12
North Florida1,1,Dallas Moore,JR,G,North Florida,A-Sun,33,1175,248,481,186,324,62,157,91,130,20,108,128,200,31,5,59,28,649
North Florida2,2,Trent Mackey,SR,G,North Florida,A-Sun,33,1142,123,271,16,40,107,231,46,56,12,68,80,60,20,2,35,65,399
North Florida3,3,Beau Beech,SR,G,North Florida,A-Sun,33,1049,163,357,67,132,96,225,87,111,39,172,211,64,42,17,53,97,509
North Florida4,4,Chris Davenport,JR,F,North Florida,A-Sun,33,891,148,281,112,183,36,98,71,99,43,197,240,107,23,66,88,92,403
North Florida5,5,BaeBae Daniels,SR,F,North Florida,A-Sun,33,841,159,301,130,217,29,84,71,101,69,102,171,44,23,70,47,101,418
North Florida6,6,Aaron Bodager,JR,G,North Florida,A-Sun,33,705,67,136,12,18,55,118,22,27,26,68,94,40,17,3,20,58,211
North Florida7,7,Nick Malonga,SO,G,North Florida,A-Sun,33,567,54,131,39,77,15,54,21,42,23,56,79,23,9,6,33,57,144
North Florida8,8,Karlos Odum,FR,F,North Florida,A-Sun,20,106,5,16,5,16,0,0,14,17,10,12,22,3,4,0,5,18,24
North Florida9,9,Osborn Blount,SO,G,North Florida,A-Sun,16,62,5,24,3,14,2,10,12,15,2,6,8,5,4,0,6,16,24
North Florida10,10,Ismaila Dauda,SR,C,North Florida,A-Sun,14,52,4,11,4,11,0,0,8,13,1,11,12,1,0,1,8,5,16
North Texas1,1,J-Mychal Reese,JR,G,North Texas,CUSA,32,1073,164,390,126,266,38,124,105,138,17,76,93,118,34,0,101,76,471
North Texas2,2,Deckie Johnson,JR,G,North Texas,CUSA,31,1007,140,361,67,141,73,220,98,124,44,95,139,69,29,6,59,77,451
North Texas3,3,Jeremy Combs,SO,F,North Texas,CUSA,31,981,175,291,175,291,0,0,111,190,107,218,325,24,42,23,61,93,461
North Texas4,4,Ja'Michael Brown,FR,G,North Texas,CUSA,32,868,93,230,38,90,55,140,22,45,17,65,82,79,37,1,58,71,263
North Texas5,5,Allante Holston,FR,G,North Texas,CUSA,31,575,35,87,34,81,1,6,46,66,7,66,73,28,16,7,23,56,117
North Texas6,6,Eric Katenda,SR,F,North Texas,CUSA,31,525,78,140,77,139,1,1,51,73,45,66,111,7,15,22,37,92,208
North Texas7,7,Carrington Ward,JR,G,North Texas,CUSA,30,406,38,98,24,48,14,50,32,43,10,26,36,21,18,2,28,58,122
North Texas8,8,Rickey Brice Jr.,FR,C,North Texas,CUSA,29,395,60,120,60,120,0,0,27,58,20,83,103,2,5,36,33,72,147
North Texas9,9,Khalil Fuller,FR,F,North Texas,CUSA,31,304,28,59,28,58,0,1,18,44,32,36,68,2,3,0,24,41,74
North Texas10,10,Greg White-Pittman,SO,G,North Texas,CUSA,30,139,8,23,8,22,0,1,15,35,6,7,13,5,7,0,8,25,31
North Texas11,11,Todd Eaglin,SR,G,North Texas,CUSA,21,70,1,12,1,2,0,10,4,6,1,6,7,3,1,0,3,10,6
North Texas12,12,DeAndre Harris,JR,G,North Texas,CUSA,4,55,10,20,5,9,5,11,9,11,0,13,13,4,2,1,2,9,34
Northeastern1,1,David Walker,SR,G,Northeastern,CAA,33,1263,179,399,82,164,97,235,136,157,19,108,127,131,47,12,62,30,591
Northeastern2,2,Quincy Ford,SR,F,Northeastern,CAA,29,1008,158,386,93,199,65,187,96,129,45,157,202,75,43,25,63,62,477
Northeastern3,3,Zach Stahl,SR,G,Northeastern,CAA,32,949,134,257,133,253,1,4,69,97,50,145,195,72,27,18,92,89,338
Northeastern4,4,Jeremy Miller,FR,G,Northeastern,CAA,33,679,96,188,65,105,31,83,51,67,45,85,130,14,12,27,32,103,274
Northeastern5,5,T.J. Williams,JR,G,Northeastern,CAA,28,656,62,132,55,100,7,32,59,93,10,46,56,75,19,3,38,50,190
Northeastern6,6,Caleb Donnelly,SR,G,Northeastern,CAA,32,653,48,126,7,22,41,104,11,15,13,40,53,25,8,1,18,31,148
Northeastern7,7,Kwesi Abakah,JR,F,Northeastern,CAA,33,427,16,46,16,46,0,0,18,41,30,42,72,17,5,9,21,53,50
Northeastern8,8,Devon Begley,SO,G,Northeastern,CAA,30,378,28,97,17,53,11,44,21,30,7,28,35,33,12,3,29,46,88
Northeastern9,9,Donnell Gresham Jr.,FR,G,Northeastern,CAA,19,333,18,56,3,20,15,36,19,28,10,31,41,24,11,0,15,25,70
Northeastern10,10,Jimmy Marshall,JR,F,Northeastern,CAA,22,212,20,50,7,14,13,36,7,10,5,34,39,13,8,1,10,18,60
Northeastern11,11,Anthony Green,FR,C,Northeastern,CAA,20,106,14,26,14,26,0,0,8,15,8,15,23,1,1,8,4,23,36
Northeastern12,12,Brandon Kamga,FR,G,Northeastern,CAA,15,101,16,35,11,26,5,9,8,16,7,10,17,4,4,0,5,11,45
Northeastern13,13,Sajon Ford,FR,F,Northeastern,CAA,9,60,4,10,4,10,0,0,1,6,5,9,14,1,5,2,5,5,9
Northern Arizona1,1,Ako Kaluna,JR,F,Northern Arizona,Big Sky,30,945,138,337,108,239,30,98,67,104,51,165,216,35,22,17,50,80,373
Northern Arizona2,2,Kris Yanku,JR,G,Northern Arizona,Big Sky,29,909,119,337,95,266,24,71,164,200,23,135,158,139,51,3,95,75,426
Northern Arizona3,3,Marcus DeBerry,FR,G,Northern Arizona,Big Sky,30,870,81,226,31,79,50,147,15,18,14,69,83,47,24,6,34,33,227
Northern Arizona4,4,Torry Johnson,FR,G,Northern Arizona,Big Sky,29,843,92,203,77,160,15,43,71,108,22,54,76,46,18,2,47,81,270
Northern Arizona5,5,Mike Green,FR,G,Northern Arizona,Big Sky,29,706,81,228,39,110,42,118,26,40,10,56,66,54,23,0,55,33,230
Northern Arizona6,6,Felix Rivera-Vega,FR,F,Northern Arizona,Big Sky,27,400,44,97,30,60,14,37,20,41,34,70,104,6,12,2,21,49,122
Northern Arizona7,7,Corey Brown,FR,F,Northern Arizona,Big Sky,30,362,45,74,45,74,0,0,19,37,33,43,76,2,7,8,22,82,109
Northern Arizona8,8,Jaleni Neely,SR,G,Northern Arizona,Big Sky,9,278,26,76,6,20,20,56,23,29,3,22,25,19,14,1,11,21,95
Northern Arizona9,9,Isaiah Thomas,FR,F,Northern Arizona,Big Sky,30,257,24,45,24,45,0,0,11,17,14,31,45,2,2,13,11,63,59
Northern Arizona10,10,Brady Twombly,FR,F,Northern Arizona,Big Sky,21,232,21,52,7,12,14,40,6,8,8,25,33,3,4,4,9,18,62
Northern Arizona11,11,Kye de Laveaga,SO,G,Northern Arizona,Big Sky,18,161,8,36,0,2,8,34,6,7,0,10,10,14,5,2,5,18,30
Northern Arizona12,12,Jordyn Martin,SR,F,Northern Arizona,Big Sky,3,82,9,19,9,18,0,1,2,2,7,3,10,2,3,0,6,5,20
Northern Arizona13,13,Junior Searcy,FR,G,Northern Arizona,Big Sky,6,55,7,12,6,10,1,2,5,6,4,6,10,1,0,1,2,5,20
Northern Arizona14,14,Steven Stanley,FR,F,Northern Arizona,Big Sky,5,12,2,3,2,3,0,0,0,0,0,2,2,1,0,0,2,0,4
Northern Arizona15,15,Austin Lee,SO,G,Northern Arizona,Big Sky,3,6,1,1,0,0,1,1,0,0,0,1,1,1,0,0,4,0,3
Northern Arizona16,16,Omar Ndiaye,FR,G,Northern Arizona,Big Sky,3,3,1,2,0,0,1,2,0,0,0,1,1,0,0,0,0,0,3
Northern Colorado1,1,Jordan Wilson,JR,G,Northern Colorado,Big Sky,31,983,140,314,75,154,65,160,63,82,10,79,89,88,23,1,50,74,408
Northern Colorado2,2,Anthony Johnson,JR,G,Northern Colorado,Big Sky,31,896,157,350,91,182,66,168,110,128,38,104,142,26,22,8,61,74,490
Northern Colorado3,3,Jordan Davis,FR,G,Northern Colorado,Big Sky,31,825,117,237,106,202,11,35,95,136,18,95,113,66,40,12,67,98,340
Northern Colorado4,4,Jeremy Verhagen,SO,F,Northern Colorado,Big Sky,31,628,70,134,65,114,5,20,49,74,43,74,117,9,9,21,44,77,194
Northern Colorado5,5,Tanner Morgan,JR,F,Northern Colorado,Big Sky,31,598,55,149,54,145,1,4,36,54,41,93,134,23,11,7,31,68,147
Northern Colorado6,6,Dallas Anglin,JR,G,Northern Colorado,Big Sky,20,555,81,180,61,116,20,64,82,103,5,52,57,44,20,1,53,50,264
Northern Colorado7,7,Ibrahim Sylla,FR,F,Northern Colorado,Big Sky,28,420,51,96,51,96,0,0,29,61,46,65,111,5,18,14,32,82,131
Northern Colorado8,8,Tyler Loose,SO,G,Northern Colorado,Big Sky,28,335,6,28,5,24,1,4,10,17,5,37,42,27,17,0,12,37,23
Northern Colorado9,9,Jon'te Dotson,JR,G,Northern Colorado,Big Sky,17,289,15,36,9,15,6,21,12,17,8,29,37,5,7,3,27,41,48
Northern Colorado10,10,Spencer Mathis,SO,F,Northern Colorado,Big Sky,23,272,26,64,24,57,2,7,10,15,19,31,50,13,6,6,10,50,64
Northern Colorado11,11,Miles Seward,FR,G,Northern Colorado,Big Sky,18,136,18,40,9,17,9,23,13,14,4,11,15,5,3,0,12,12,58
Northern Colorado12,12,Cameron Michael,JR,G,Northern Colorado,Big Sky,4,135,23,53,16,32,7,21,14,15,2,22,24,8,2,0,9,11,67
Northern Colorado13,13,Jamal Evans,JR,F,Northern Colorado,Big Sky,16,128,21,45,11,27,10,18,6,11,8,20,28,1,0,5,10,29,58
Northern Illinois1,1,Aaric Armstead,JR,G,Northern Illinois,MAC,33,953,116,308,75,181,41,127,85,127,54,131,185,39,33,15,62,73,358
Northern Illinois2,2,Travon Baker,SR,G,Northern Illinois,MAC,33,945,105,283,40,106,65,177,89,115,19,90,109,124,47,1,70,74,364
Northern Illinois3,3,Marin Maric,SO,C,Northern Illinois,MAC,31,819,135,278,128,262,7,16,99,149,93,170,263,29,22,38,60,74,376
Northern Illinois4,4,Michael Orris,JR,G,Northern Illinois,MAC,32,699,36,129,31,88,5,41,11,21,8,38,46,96,23,1,47,64,88
Northern Illinois5,5,Jaylen Key,FR,F,Northern Illinois,MAC,33,606,75,160,75,158,0,2,36,54,39,81,120,23,18,15,37,86,186
Northern Illinois6,6,Marshawn Wilson,FR,G,Northern Illinois,MAC,30,567,103,238,48,104,55,134,67,90,21,60,81,31,20,1,29,54,328
Northern Illinois7,7,Laytwan Porter,FR,G,Northern Illinois,MAC,33,566,53,144,32,74,21,70,34,44,14,59,73,76,35,4,47,57,161
Northern Illinois8,8,Chuks Iroegbu,SR,G,Northern Illinois,MAC,33,544,69,107,67,98,2,9,60,97,31,50,81,23,18,15,25,65,200
Northern Illinois9,9,Levi Bradley,FR,G,Northern Illinois,MAC,33,527,81,166,60,117,21,49,35,46,35,81,116,14,13,10,22,70,218
Northern Illinois10,10,Andrew Zelis,SO,C,Northern Illinois,MAC,27,196,24,45,24,45,0,0,6,17,14,45,59,2,2,12,8,40,54
Northern Illinois11,11,Austin Pauga,FR,G,Northern Illinois,MAC,20,179,20,40,6,9,14,31,1,2,4,7,11,7,10,2,7,10,55
Northern Illinois12,12,Jay DeHaan,SO,G,Northern Illinois,MAC,8,25,1,8,1,6,0,2,1,3,1,7,8,1,0,0,1,0,3
Northern Illinois13,13,Jordan Thomas,SO,G,Northern Illinois,MAC,7,24,3,10,0,2,3,8,0,0,1,3,4,1,0,0,2,0,9
Northern Iowa1,1,Matt Bohannon,SR,G,Northern Iowa,MVC,34,1188,131,291,40,69,91,222,48,58,1,137,138,33,28,3,24,63,401
Northern Iowa2,2,Wes Washpun,SR,G,Northern Iowa,MVC,34,1169,170,359,144,275,26,84,119,165,8,129,137,177,41,22,88,85,485
Northern Iowa3,3,Jeremy Morgan,JR,G,Northern Iowa,MVC,34,1075,113,237,69,127,44,110,83,105,41,133,174,79,66,29,46,78,353
Northern Iowa4,4,Paul Jesperson,SR,G,Northern Iowa,MVC,34,1030,123,289,48,97,75,192,42,48,18,123,141,31,14,9,36,65,363
Northern Iowa5,5,Bennett Koch,SO,F,Northern Iowa,MVC,34,640,96,192,96,192,0,0,70,96,33,90,123,15,9,13,48,87,262
Northern Iowa6,6,Klint Carlson,SO,F,Northern Iowa,MVC,30,640,79,168,68,122,11,46,40,51,23,88,111,17,19,7,27,54,209
Northern Iowa7,7,Wyatt Lohaus,SO,G,Northern Iowa,MVC,34,607,52,127,35,78,17,49,19,24,3,44,47,36,12,0,28,32,140
Northern Iowa8,8,Ted Friedman,SO,C,Northern Iowa,MVC,34,295,14,29,14,28,0,1,3,18,18,27,45,9,2,5,9,40,31
Northern Iowa9,9,Aarias Austin,JR,G,Northern Iowa,MVC,9,120,17,43,7,17,10,26,5,5,0,16,16,7,2,0,8,7,49
Northern Iowa10,10,Robert Knar,SO,G,Northern Iowa,MVC,12,35,4,14,2,4,2,10,3,4,0,7,7,0,0,0,0,2,13
Northern Iowa11,11,Lincoln Conrey,FR,F,Northern Iowa,MVC,1,26,2,3,0,1,2,2,0,0,0,2,2,2,0,0,3,2,6
Northern Kentucky1,1,Tyler White,SR,G,Northern Kentucky,A-Sun,30,918,127,354,83,189,44,165,63,82,11,71,82,105,27,5,75,78,361
Northern Kentucky2,2,Cole Murray,JR,G,Northern Kentucky,A-Sun,30,827,108,220,30,48,78,172,8,10,9,98,107,23,9,7,30,69,302
Northern Kentucky3,3,LaVone Holland,SO,G,Northern Kentucky,A-Sun,28,810,109,274,77,188,32,86,50,85,13,118,131,113,29,1,85,57,300
Northern Kentucky4,4,Jordan Garnett,SO,F,Northern Kentucky,A-Sun,30,593,39,92,32,70,7,22,27,38,37,46,83,31,15,8,24,70,112
Northern Kentucky5,5,Jalen Billups,SR,C,Northern Kentucky,A-Sun,30,592,142,243,142,243,0,0,80,121,53,111,164,21,7,40,54,81,364
Northern Kentucky6,6,Drew McDonald,FR,C,Northern Kentucky,A-Sun,30,581,109,226,102,201,7,25,89,122,64,122,186,34,8,11,43,56,314
Northern Kentucky7,7,Deontae Cole,JR,F,Northern Kentucky,A-Sun,27,387,30,77,6,9,24,68,0,0,5,21,26,23,3,3,4,22,84
Northern Kentucky8,8,Dean Danos,JR,G,Northern Kentucky,A-Sun,29,377,29,64,7,18,22,46,16,24,4,39,43,41,11,0,32,44,96
Northern Kentucky9,9,Todd Johnson,SR,G,Northern Kentucky,A-Sun,20,254,18,47,6,11,12,36,6,10,4,17,21,29,11,1,13,27,54
Northern Kentucky10,10,Brennan Gillis,FR,F,Northern Kentucky,A-Sun,29,253,18,53,13,39,5,14,19,27,19,25,44,7,9,7,23,43,60
Northern Kentucky11,11,Matt Rosenwinkel,JR,G,Northern Kentucky,A-Sun,24,239,4,24,1,3,3,21,5,6,3,18,21,4,6,0,5,24,16
Northern Kentucky12,12,Jake Giesler,SR,F,Northern Kentucky,A-Sun,30,213,22,44,22,44,0,0,9,18,17,32,49,8,7,5,13,44,53
Northwestern1,1,Tre Demps,SR,G,Northwestern,Big Ten,32,1185,189,475,117,258,72,217,51,77,16,98,114,104,21,1,39,28,501
Northwestern2,2,Bryant McIntosh,SO,G,Northwestern,Big Ten,32,1142,161,381,112,247,49,134,70,85,12,104,116,213,31,5,78,65,441
Northwestern3,3,Aaron Falzon,FR,F,Northwestern,Big Ten,32,785,87,227,24,49,63,178,33,46,42,67,109,28,11,10,21,74,270
Northwestern4,4,Sanjay Lumpkin,JR,G,Northwestern,Big Ten,32,757,42,86,29,50,13,36,26,38,45,114,159,40,17,8,34,93,123
Northwestern5,5,Alex Olah,SR,C,Northwestern,Big Ten,26,623,116,220,108,193,8,27,57,83,36,109,145,35,5,36,31,58,297
Northwestern6,6,Scottie Lindsey,SO,G,Northwestern,Big Ten,31,585,71,163,33,70,38,93,17,23,12,60,72,43,15,7,26,67,197
Northwestern7,7,Gavin Skelly,SO,F,Northwestern,Big Ten,30,381,33,54,29,45,4,9,29,45,35,57,92,16,7,14,25,58,99
Northwestern8,8,Dererk Pardon,FR,C,Northwestern,Big Ten,20,332,53,82,53,82,0,0,27,51,35,49,84,6,4,12,14,48,133
Northwestern9,9,Joey van Zegeren,SR,F,Northwestern,Big Ten,25,286,34,55,34,55,0,0,23,51,35,39,74,4,7,20,23,59,91
Northwestern10,10,Nathan Taphorn,JR,F,Northwestern,Big Ten,24,282,39,87,12,20,27,67,12,19,12,42,54,16,4,8,17,37,117
Northwestern11,11,Jordan Ash,FR,G,Northwestern,Big Ten,27,156,12,29,8,14,4,15,7,10,2,14,16,22,2,0,7,17,35
Northwestern State1,1,Zeek Woodley,JR,G,Northwestern State,Southland,28,925,216,407,159,267,57,140,133,150,47,98,145,44,27,16,55,67,622
Northwestern State2,2,Devonte Hall,SO,G,Northwestern State,Southland,27,786,100,242,83,191,17,51,77,109,16,76,92,171,44,2,80,74,294
Northwestern State3,3,Sabri Thompson,JR,G,Northwestern State,Southland,28,766,118,273,62,129,56,144,62,76,29,62,91,62,18,8,54,58,354
Northwestern State4,4,Ishmael Lane,FR,F,Northwestern State,Southland,28,703,120,212,120,211,0,1,82,121,56,102,158,16,20,27,44,86,322
Northwestern State5,5,Tra'von Joseph,JR,G,Northwestern State,Southland,23,484,37,100,29,76,8,24,22,29,26,62,88,24,10,3,21,60,104
Northwestern State6,6,Matt Killian,SR,F,Northwestern State,Southland,28,468,33,88,22,55,11,33,18,27,20,41,61,10,18,7,23,33,95
Northwestern State7,7,Ta'Jon Welcome,SR,G,Northwestern State,Southland,28,436,53,129,37,65,16,64,23,30,12,31,43,26,9,4,26,32,145
Northwestern State8,8,Bailey Walker,FR,G,Northwestern State,Southland,27,308,26,65,12,37,14,28,14,19,5,17,22,39,11,1,43,36,80
Northwestern State9,9,Malik Metoyer,FR,G,Northwestern State,Southland,28,240,22,52,16,27,6,25,16,24,12,28,40,12,6,5,18,30,66
Northwestern State10,10,Levi Yancy,JR,F,Northwestern State,Southland,24,235,14,37,14,35,0,2,10,10,12,27,39,14,6,7,16,31,38
Northwestern State11,11,Reggie Kissoonlal,SO,G,Northwestern State,Southland,22,176,22,63,7,14,15,49,14,18,7,23,30,7,4,10,19,47,73
Northwestern State12,12,Jalan West,SR,G,Northwestern State,Southland,1,30,8,13,2,3,6,10,3,4,0,3,3,6,0,0,2,3,25
Northwestern State13,13,Daniel Hazlewood,JR,G,Northwestern State,Southland,9,15,1,4,0,0,1,4,0,0,1,4,5,1,0,0,1,1,3
Notre Dame1,1,Steve Vasturia,JR,G,Notre Dame,ACC,32,1158,136,302,95,187,41,115,65,76,20,66,86,100,24,6,57,71,378
Notre Dame2,2,Demetrius Jackson,JR,G,Notre Dame,ACC,31,1104,167,378,119,230,48,148,100,125,30,78,108,150,38,9,66,61,482
Notre Dame3,3,V.J. Beachem,JR,F,Notre Dame,ACC,32,983,133,294,57,118,76,176,21,39,26,97,123,25,25,26,26,53,363
Notre Dame4,4,Zach Auguste,SR,F,Notre Dame,ACC,32,951,174,317,174,317,0,0,112,177,107,237,344,37,22,32,81,79,460
Notre Dame5,5,Bonzie Colson,SO,F,Notre Dame,ACC,32,832,140,261,136,249,4,12,84,111,79,144,223,34,28,33,32,77,368
Notre Dame6,6,Matt Ryan,FR,F,Notre Dame,ACC,32,496,59,141,14,21,45,120,19,24,4,52,56,17,9,3,6,55,182
Notre Dame7,7,Rex Pflueger,FR,G,Notre Dame,ACC,26,363,20,52,12,27,8,25,18,19,8,28,36,31,17,5,7,35,66
Notre Dame8,8,Matt Farrell,SO,G,Notre Dame,ACC,24,267,13,46,6,19,7,27,13,15,5,13,18,31,4,0,12,21,46
Notre Dame9,9,Austin Torres,JR,F,Notre Dame,ACC,26,119,10,20,10,20,0,0,4,10,15,10,25,3,9,6,6,20,24
Notre Dame10,10,Austin Burgett,SR,F,Notre Dame,ACC,17,97,11,19,5,7,6,12,4,6,3,12,15,3,2,4,4,13,32
Notre Dame11,11,Martinas Geben,SO,F,Notre Dame,ACC,16,48,6,11,6,11,0,0,10,10,5,10,15,0,1,2,4,11,22
Oakland1,1,Kay Felder,JR,G,Oakland,Horizon,32,1176,243,554,175,362,68,192,219,259,21,111,132,296,65,7,110,99,773
Oakland2,2,Jalen Hayes,SO,F,Oakland,Horizon,31,960,163,303,160,294,3,9,102,139,71,202,273,24,28,16,48,91,431
Oakland3,3,Sherron Dorsey-Walker,JR,G,Oakland,Horizon,32,808,61,169,31,86,30,83,62,90,59,109,168,47,25,5,49,58,214
Oakland4,4,Max Hooper,SR,G,Oakland,Horizon,32,793,105,234,0,0,105,234,21,22,4,51,55,15,11,3,22,32,336
Oakland5,5,Percy Gibson,SR,C,Oakland,Horizon,32,712,143,275,142,273,1,2,73,101,70,135,205,22,18,31,42,95,360
Oakland6,6,Nick Daniels,SO,G,Oakland,Horizon,32,649,66,181,23,67,43,114,36,47,15,64,79,52,23,1,36,51,211
Oakland7,7,Martez Walker,SO,G,Oakland,Horizon,23,536,71,141,42,74,29,67,75,92,35,46,81,22,8,9,23,44,246
Oakland8,8,Xavier Hill-Mais,FR,F,Oakland,Horizon,29,241,24,44,24,43,0,1,21,32,16,43,59,4,5,9,15,48,69
Oakland9,9,Brad Brechting,FR,C,Oakland,Horizon,32,237,22,47,22,47,0,0,15,25,21,42,63,6,4,28,11,57,59
Oakland10,10,Femi Olujobi,SO,F,Oakland,Horizon,27,182,12,33,12,31,0,2,6,13,20,21,41,6,1,3,6,23,30
Oakland11,11,Jaevin Cumberland,FR,G,Oakland,Horizon,27,131,10,25,5,11,5,14,8,11,3,8,11,6,3,0,6,15,33
Ohio1,1,Jaaron Simmons,SO,G,Ohio,MAC,32,1159,158,334,128,263,30,71,141,187,7,105,112,250,26,0,128,99,487
Ohio2,2,Jordan Dartis,FR,G,Ohio,MAC,29,922,87,180,24,48,63,132,48,53,2,54,56,39,21,2,28,52,285
Ohio3,3,Antonio Campbell,JR,F,Ohio,MAC,32,917,222,387,180,283,42,104,76,105,69,249,318,21,22,56,40,101,562
Ohio4,4,Kenny Kaminski,JR,F,Ohio,MAC,30,913,120,313,45,104,75,209,65,76,13,103,116,40,15,10,34,71,380
Ohio5,5,Treg Setty,SR,F,Ohio,MAC,32,876,134,281,108,205,26,76,64,89,46,111,157,24,23,9,52,92,358
Ohio6,6,Gavin Block,FR,G,Ohio,MAC,31,583,47,114,24,53,23,61,53,64,7,58,65,50,12,0,27,50,170
Ohio7,7,Mike Laster,SO,G,Ohio,MAC,30,291,24,55,23,48,1,7,13,18,13,13,26,4,1,0,15,26,62
Ohio8,8,Wadly Mompremier,JR,F,Ohio,MAC,29,269,27,48,25,43,2,5,22,46,32,60,92,3,4,34,18,34,78
Ohio9,9,Khari Harley,SO,G,Ohio,MAC,17,245,16,49,12,31,4,18,17,25,7,18,25,8,7,3,9,24,53
Ohio10,10,Doug Taylor,FR,F,Ohio,MAC,26,118,14,28,13,27,1,1,12,16,22,23,45,2,5,3,5,29,41
Ohio11,11,James Gollon,FR,G,Ohio,MAC,19,108,6,18,2,7,4,11,5,8,2,12,14,5,2,0,15,11,21
Ohio12,12,Drew Crabtree,JR,G,Ohio,MAC,9,9,2,4,0,0,2,4,0,0,1,2,3,1,0,0,0,1,6
Ohio13,13,Sam Frayer,SO,F,Ohio,MAC,10,8,1,6,1,6,0,0,0,0,3,1,4,0,0,0,1,0,2
Ohio14,14,Jaylin McDonald,FR,F,Ohio,MAC,8,7,1,1,1,1,0,0,1,2,0,0,0,1,0,0,0,0,3
Ohio State1,1,Marc Loving,JR,F,Ohio State,Big Ten,33,1104,138,336,86,184,52,152,124,164,36,131,167,52,20,14,78,54,452
Ohio State2,2,Keita Bates-Diop,SO,F,Ohio State,Big Ten,33,1040,141,311,105,200,36,111,70,89,47,163,210,36,24,41,45,61,388
Ohio State3,3,JaQuan Lyle,FR,G,Ohio State,Big Ten,33,958,120,302,90,188,30,114,84,122,21,118,139,139,33,10,94,54,354
Ohio State4,4,Jae'Sean Tate,SO,F,Ohio State,Big Ten,28,813,135,259,121,219,14,40,44,85,55,124,179,42,35,9,45,85,328
Ohio State5,5,Kam Williams,SO,G,Ohio State,Big Ten,33,684,99,216,50,112,49,104,16,20,12,40,52,25,23,5,17,35,263
Ohio State6,6,Trevor Thompson,SO,C,Ohio State,Big Ten,33,596,83,153,83,153,0,0,58,78,58,108,166,6,10,41,38,90,224
Ohio State7,7,Daniel Giddens,FR,C,Ohio State,Big Ten,31,551,47,103,47,102,0,1,20,50,40,67,107,9,17,46,31,100,114
Ohio State8,8,A.J. Harris,FR,G,Ohio State,Big Ten,33,428,29,90,15,45,14,45,17,26,2,31,33,54,11,1,33,37,89
Ohio State9,9,Mickey Mitchell,FR,F,Ohio State,Big Ten,21,255,15,38,15,36,0,2,8,19,19,39,58,15,6,6,22,37,38
Ohio State10,10,David Bell,FR,C,Ohio State,Big Ten,22,120,6,13,6,13,0,0,14,24,18,16,34,1,1,5,4,23,26
Ohio State11,11,Austin Grandstaff,FR,G,Ohio State,Big Ten,10,115,16,41,4,5,12,36,0,0,0,3,3,0,3,0,6,6,44
Ohio State12,12,Joey Lane,FR,G,Ohio State,Big Ten,7,11,1,7,0,0,1,7,1,2,0,0,0,0,0,0,0,2,4
Oklahoma1,1,Buddy Hield,SR,G,Oklahoma,Big 12,32,1121,259,522,132,248,127,274,154,172,35,144,179,67,38,16,95,66,799
Oklahoma2,2,Isaiah Cousins,SR,G,Oklahoma,Big 12,32,1070,150,358,93,224,57,134,59,88,23,125,148,146,46,8,71,54,416
Oklahoma3,3,Ryan Spangler,SR,F,Oklahoma,Big 12,32,1064,132,240,100,155,32,85,49,78,80,221,301,60,15,18,55,72,345
Oklahoma4,4,Jordan Woodard,JR,G,Oklahoma,Big 12,32,953,127,312,60,161,67,151,81,100,24,71,95,110,51,6,51,75,402
Oklahoma5,5,Khadeem Lattin,SO,F,Oklahoma,Big 12,32,713,72,130,72,129,0,1,30,53,69,108,177,22,31,71,28,93,174
Oklahoma6,6,Dinjiyl Walker,SR,G,Oklahoma,Big 12,32,417,42,117,15,45,27,72,8,17,11,39,50,28,17,1,25,42,119
Oklahoma7,7,Dante Buford,FR,F,Oklahoma,Big 12,31,389,33,97,22,63,11,34,34,45,19,41,60,15,8,9,22,32,111
Oklahoma8,8,Christian James,FR,G,Oklahoma,Big 12,30,248,22,50,10,26,12,24,22,29,7,35,42,10,8,3,18,23,78
Oklahoma9,9,Akolda Manyang,JR,C,Oklahoma,Big 12,24,185,23,46,23,46,0,0,15,24,15,33,48,0,1,31,13,34,61
Oklahoma10,10,Jamuni McNeace,FR,C,Oklahoma,Big 12,22,156,9,18,9,18,0,0,8,19,12,20,32,1,2,4,8,30,26
Oklahoma11,11,Rashard Odomes,FR,G,Oklahoma,Big 12,15,100,10,21,9,18,1,3,10,19,4,10,14,6,2,0,12,10,31
Oklahoma12,12,C.J. Cole,JR,F,Oklahoma,Big 12,8,23,3,6,3,4,0,2,0,1,0,3,3,0,0,0,3,6,6
Oklahoma13,13,Austin Mankin,JR,F,Oklahoma,Big 12,6,13,1,3,1,2,0,1,1,2,2,1,3,0,0,0,1,1,3
Oklahoma14,14,Bola Alade,FR,G,Oklahoma,Big 12,6,13,1,5,1,3,0,2,0,0,0,2,2,0,0,0,1,0,2
Oklahoma State1,1,Jeff Newberry,SR,G,Oklahoma State,Big 12,32,969,113,294,81,191,32,103,89,108,36,115,151,48,49,16,38,70,347
Oklahoma State2,2,Tyree Griffin,SO,G,Oklahoma State,Big 12,30,820,45,137,31,79,14,58,53,72,17,73,90,118,24,1,52,41,157
Oklahoma State3,3,Leyton Hammonds,JR,G,Oklahoma State,Big 12,28,798,108,253,69,139,39,114,41,52,40,103,143,24,19,8,41,91,296
Oklahoma State4,4,Jeffrey Carroll,SO,G,Oklahoma State,Big 12,30,738,87,212,47,92,40,120,33,47,18,101,119,19,17,8,35,42,247
Oklahoma State5,5,Jawun Evans,FR,G,Oklahoma State,Big 12,22,635,97,206,78,166,19,40,70,84,10,86,96,108,25,4,56,54,283
Oklahoma State6,6,Mitchell Solomon,SO,F,Oklahoma State,Big 12,31,570,40,85,37,66,3,19,32,46,53,68,121,14,11,17,43,106,115
Oklahoma State7,7,Tavarius Shine,SO,G,Oklahoma State,Big 12,25,566,45,131,18,44,27,87,35,46,16,67,83,14,19,9,27,70,152
Oklahoma State8,8,Chris Olivier,SR,F,Oklahoma State,Big 12,32,518,94,182,94,182,0,0,60,94,36,58,94,10,4,32,32,57,248
Oklahoma State9,9,Joe Burton,SO,G,Oklahoma State,Big 12,30,377,47,106,22,43,25,63,23,39,8,35,43,19,7,2,19,39,142
Oklahoma State10,10,Anthony Allen,SR,F,Oklahoma State,Big 12,31,345,33,66,33,66,0,0,25,43,26,48,74,14,1,35,34,54,91
Oklahoma State11,11,Phil Forte,SR,G,Oklahoma State,Big 12,3,77,11,26,5,10,6,16,12,14,1,3,4,0,1,0,1,1,40
Oklahoma State12,12,Davon Dillard,FR,G,Oklahoma State,Big 12,6,24,2,5,2,3,0,2,0,1,3,0,3,0,1,0,0,7,4
Oklahoma State13,13,Igor Ibaka,SO,F,Oklahoma State,Big 12,7,23,1,2,1,2,0,0,4,8,3,5,8,0,1,0,2,2,6
Old Dominion1,1,Trey Freeman,SR,G,Old Dominion,CUSA,35,1233,300,701,253,569,47,132,131,158,18,126,144,108,35,4,45,63,778
Old Dominion2,2,Denzell Taylor,JR,F,Old Dominion,CUSA,35,913,65,110,65,109,0,1,18,39,144,110,254,33,32,22,47,108,148
Old Dominion3,3,Aaron Bacote,SR,G,Old Dominion,CUSA,35,904,139,326,100,210,39,116,126,156,10,86,96,76,30,6,52,81,443
Old Dominion4,4,Jordan Baker,JR,G,Old Dominion,CUSA,35,904,43,132,14,25,29,107,12,25,5,81,86,75,37,3,36,73,127
Old Dominion5,5,Brandan Stith,SO,F,Old Dominion,CUSA,29,791,122,221,122,221,0,0,62,130,109,172,281,12,16,61,38,76,306
Old Dominion6,6,Zoran Talley,FR,F,Old Dominion,CUSA,32,759,116,227,113,215,3,12,30,43,40,112,152,52,15,3,30,47,265
Old Dominion7,7,Nik Biberaj,SR,F,Old Dominion,CUSA,33,637,57,151,49,113,8,38,30,41,43,67,110,32,12,26,14,72,152
Old Dominion8,8,Ahmad Caver,FR,G,Old Dominion,CUSA,31,478,28,88,18,52,10,36,18,36,6,44,50,53,17,11,25,39,84
Old Dominion9,9,Stephen Vassor,SO,F,Old Dominion,CUSA,30,200,20,33,20,33,0,0,6,9,21,23,44,8,1,4,11,42,46
Old Dominion10,10,Ambrose Mosley,JR,G,Old Dominion,CUSA,5,92,6,24,2,5,4,19,1,2,3,18,21,4,2,0,7,12,17
Old Dominion11,11,Aaron Carver,FR,F,Old Dominion,CUSA,4,58,6,14,3,6,3,8,0,0,2,9,11,6,2,1,5,9,15
Old Dominion12,12,Martin Shaw,SR,G,Old Dominion,CUSA,14,54,4,16,4,10,0,6,4,4,0,1,1,2,2,1,3,16,12
Old Dominion13,13,Payton Pervier,SR,C,Old Dominion,CUSA,3,27,1,8,1,8,0,0,2,5,3,3,6,0,0,2,2,4,4
Oral Roberts1,1,Obi Emegano,JR,G,Oral Roberts,Summit,29,1026,210,484,159,350,51,134,198,232,28,121,149,53,33,10,51,69,669
Oral Roberts2,2,Jalen Bradley,JR,G,Oral Roberts,Summit,31,781,95,222,56,123,39,99,33,43,22,58,80,61,28,1,34,39,262
Oral Roberts3,3,Albert Owens,SO,C,Oral Roberts,Summit,31,739,119,266,118,257,1,9,69,108,41,114,155,22,11,47,38,53,308
Oral Roberts4,4,Aaron Anderson,SR,G,Oral Roberts,Summit,30,681,41,91,30,62,11,29,34,44,21,74,95,73,15,1,54,70,127
Oral Roberts5,5,Kris Martin,FR,G,Oral Roberts,Summit,31,649,82,203,45,93,37,110,37,54,8,73,81,38,16,12,39,28,238
Oral Roberts6,6,Brandon Conley,SR,F,Oral Roberts,Summit,30,591,91,162,91,162,0,0,35,57,65,97,162,34,10,18,61,106,217
Oral Roberts7,7,DaQuan Jeffries,FR,F,Oral Roberts,Summit,29,589,74,129,63,101,11,28,36,46,40,87,127,24,18,18,21,64,195
Oral Roberts8,8,Aaron Young,JR,G,Oral Roberts,Summit,31,570,56,122,24,52,32,70,27,34,4,27,31,44,13,0,23,45,171
Oral Roberts9,9,Javan White,FR,F,Oral Roberts,Summit,23,300,41,85,41,84,0,1,16,24,29,57,86,12,6,22,21,58,98
Oral Roberts10,10,Darian Harris,FR,G,Oral Roberts,Summit,23,186,13,31,3,6,10,25,3,7,4,31,35,16,9,0,13,18,39
Oral Roberts11,11,Tre Vance,JR,F,Oral Roberts,Summit,10,41,2,7,2,7,0,0,4,7,2,3,5,2,0,4,1,10,8
Oral Roberts12,12,Chris Crawford,FR,G,Oral Roberts,Summit,5,40,3,4,3,3,0,1,2,3,1,3,4,2,3,0,2,1,8
Oral Roberts13,13,Adam Glenville,SR,G,Oral Roberts,Summit,4,22,4,9,2,4,2,5,2,2,1,4,5,3,0,0,2,0,12
Oral Roberts14,14,Isaac Gilliam,SO,G,Oral Roberts,Summit,3,10,1,6,1,3,0,3,2,4,0,2,2,0,0,0,1,2,4
Oregon1,1,Dillon Brooks,SO,F,Oregon,Pac-12,34,1118,208,443,168,322,40,121,114,138,72,120,192,105,40,13,82,101,570
Oregon2,2,Elgin Cook,SR,F,Oregon,Pac-12,34,1078,170,366,150,306,20,60,134,177,52,116,168,75,52,12,73,99,494
Oregon3,3,Casey Benson,SO,G,Oregon,Pac-12,34,978,65,155,36,75,29,80,39,55,16,61,77,103,23,1,23,58,198
Oregon4,4,Tyler Dorsey,FR,G,Oregon,Pac-12,32,959,141,308,79,164,62,144,99,140,43,95,138,65,27,5,63,67,443
Oregon5,5,Chris Boucher,JR,F,Oregon,Pac-12,34,895,141,260,105,160,36,100,94,137,90,167,257,13,28,106,37,94,412
Oregon6,6,Dwayne Benjamin,SR,F,Oregon,Pac-12,34,767,93,234,51,103,42,131,45,66,20,84,104,32,38,10,35,52,273
Oregon7,7,Jordan Bell,SO,F,Oregon,Pac-12,27,526,80,138,80,136,0,2,25,48,40,87,127,36,29,43,46,68,185
Oregon8,8,Kendall Small,FR,G,Oregon,Pac-12,33,258,17,43,16,35,1,8,21,35,1,21,22,23,19,1,15,35,56
Oregon9,9,Roman Sorkin,SO,F,Oregon,Pac-12,21,113,12,27,9,14,3,13,7,8,6,12,18,4,1,1,4,13,34
Oregon10,10,Trevor Manuel,FR,F,Oregon,Pac-12,9,64,4,13,4,7,0,6,2,6,1,8,9,3,1,9,3,16,10
Oregon11,11,Dylan Ennis,SR,G,Oregon,Pac-12,3,21,1,4,1,2,0,2,0,0,1,2,3,2,0,0,2,0,2
Oregon12,12,Charlie Noebel,JR,G,Oregon,Pac-12,9,13,1,3,0,0,1,3,0,0,1,1,2,0,0,0,1,3,3
Oregon State1,1,Gary Payton,SR,G,Oregon State,Pac-12,31,1057,196,405,175,337,21,68,79,123,75,170,245,157,76,16,73,83,492
Oregon State2,2,Malcolm Duvivier,JR,G,Oregon State,Pac-12,31,786,65,171,36,89,29,82,32,53,12,63,75,68,12,5,50,53,191
Oregon State3,3,Tres Tinkle,FR,F,Oregon State,Pac-12,27,748,108,245,79,165,29,80,108,147,40,106,146,30,32,14,38,72,353
Oregon State4,4,Olaf Schaftenaar,SR,F,Oregon State,Pac-12,31,741,64,164,22,53,42,111,33,42,21,70,91,50,13,5,26,76,203
Oregon State5,5,Stephen Thompson Jr.,FR,G,Oregon State,Pac-12,31,666,116,280,70,156,46,124,56,81,24,32,56,25,36,9,27,54,334
Oregon State6,6,Drew Eubanks,FR,F,Oregon State,Pac-12,31,659,98,168,98,168,0,0,35,57,45,96,141,11,14,39,41,87,231
Oregon State7,7,Langston Morris-Walker,SR,G,Oregon State,Pac-12,31,527,51,143,26,73,25,70,34,54,19,57,76,28,20,1,19,29,161
Oregon State8,8,Derrick Bruce,FR,G,Oregon State,Pac-12,27,311,30,80,11,45,19,35,28,44,1,26,27,34,7,1,21,31,107
Oregon State9,9,Jarmal Reid,SR,F,Oregon State,Pac-12,20,296,28,74,28,74,0,0,26,40,14,29,43,11,12,5,25,56,82
Oregon State10,10,Gligorije Rakocevic,FR,C,Oregon State,Pac-12,26,186,15,31,15,31,0,0,10,15,13,21,34,3,4,0,10,33,40
Oregon State11,11,Cheikh N'diaye,JR,C,Oregon State,Pac-12,24,127,9,11,9,11,0,0,7,12,5,16,21,0,4,8,9,23,25
Oregon State12,12,Daniel Gomis,SR,F,Oregon State,Pac-12,11,78,6,10,6,10,0,0,2,2,3,4,7,0,1,1,5,25,14
Pacific1,1,T.J. Wallace,JR,G,Pacific,WCC,27,793,100,265,69,157,31,108,60,89,26,116,142,62,32,11,47,71,291
Pacific2,2,Ray Bowles,SO,G,Pacific,WCC,28,769,103,224,77,147,26,77,78,106,34,76,110,64,18,2,56,69,310
Pacific3,3,Tonko Vuko,JR,F,Pacific,WCC,28,603,59,128,51,93,8,35,36,50,38,55,93,31,9,5,27,74,162
Pacific4,4,Alec Kobre,SR,G,Pacific,WCC,22,601,95,188,35,52,60,136,40,44,3,29,32,19,6,0,21,60,290
Pacific5,5,Jacob Lampkin,SO,F,Pacific,WCC,28,597,88,164,88,163,0,1,18,38,35,100,135,28,8,7,37,64,194
Pacific6,6,Maleke Haynes,SO,G,Pacific,WCC,28,491,33,107,22,62,11,45,26,44,5,36,41,69,15,4,46,53,103
Pacific7,7,David Taylor,JR,F,Pacific,WCC,27,427,34,105,13,30,21,75,10,17,4,32,36,24,3,1,25,38,99
Pacific8,8,D.J. Ursery,SO,G,Pacific,WCC,28,423,45,120,41,92,4,28,42,57,17,50,67,39,17,2,39,55,136
Pacific9,9,Ilias Theodorou,SO,F,Pacific,WCC,28,361,49,108,21,41,28,67,12,18,18,48,66,12,4,9,24,48,138
Pacific10,10,Eric Thompson,SR,F,Pacific,WCC,12,241,38,66,38,66,0,0,43,69,34,57,91,5,4,13,20,43,119
Pacific11,11,Anthony Townes,FR,F,Pacific,WCC,17,197,20,43,20,43,0,0,9,15,15,28,43,3,6,7,11,31,49
Pacific12,12,Sami Eleraky,JR,C,Pacific,WCC,16,166,13,27,13,27,0,0,14,26,7,23,30,2,2,10,12,27,40
Pacific13,13,Max Tinsley,FR,G,Pacific,WCC,5,20,7,12,6,8,1,4,0,0,1,2,3,0,1,0,0,1,15
Pacific14,14,Jason Braden,FR,G,Pacific,WCC,4,11,1,2,1,2,0,0,0,2,2,0,2,4,0,0,0,3,2
Penn State1,1,Shep Garner,SO,G,Penn State,Big Ten,32,1127,149,390,74,185,75,205,101,129,9,94,103,109,42,7,65,59,474
Penn State2,2,Brandon Taylor,SR,F,Penn State,Big Ten,32,1032,188,434,137,292,51,142,93,128,51,156,207,50,19,17,80,94,520
Penn State3,3,Payton Banks,SO,F,Penn State,Big Ten,32,922,108,283,68,160,40,123,45,61,36,102,138,37,26,3,45,73,301
Penn State4,4,Josh Reaves,FR,G,Penn State,Big Ten,27,620,66,176,63,137,3,39,31,41,34,62,96,50,36,23,36,68,166
Penn State5,5,Devin Foster,SR,G,Penn State,Big Ten,31,588,43,95,33,72,10,23,28,48,21,53,74,36,10,1,25,62,124
Penn State6,6,Jordan Dickerson,SR,C,Penn State,Big Ten,32,581,34,63,34,63,0,0,22,41,46,65,111,13,10,51,22,95,90
Penn State7,7,Julian Moore,SO,F,Penn State,Big Ten,31,479,41,92,41,90,0,2,37,55,30,72,102,7,8,17,19,53,119
Penn State8,8,Donovon Jack,SR,F,Penn State,Big Ten,32,443,58,117,47,82,11,35,38,64,26,67,93,5,4,18,24,82,165
Penn State9,9,Isaiah Washington,FR,G,Penn State,Big Ten,27,339,19,81,8,25,11,56,24,35,13,36,49,7,7,4,19,38,73
Penn State10,10,Deividas Zemgulis,FR,F,Penn State,Big Ten,26,318,26,68,16,28,10,40,13,19,20,24,44,8,4,0,13,20,75
Pennsylvania1,1,Matt Howard,JR,G,Pennsylvania,Ivy,28,859,125,271,92,155,33,116,60,89,48,111,159,32,25,10,43,70,343
Pennsylvania2,2,Darien Nelson-Henry,SR,C,Pennsylvania,Ivy,27,755,141,247,139,241,2,6,59,83,68,151,219,48,12,32,69,63,343
Pennsylvania3,3,Sam Jones,SO,F,Pennsylvania,Ivy,28,694,70,196,12,21,58,175,37,42,13,89,102,21,10,7,23,38,235
Pennsylvania4,4,Jackson Donahue,FR,G,Pennsylvania,Ivy,26,659,82,207,20,43,62,164,27,44,15,37,52,32,15,1,23,43,253
Pennsylvania5,5,Jake Silpe,FR,G,Pennsylvania,Ivy,28,628,45,124,30,76,15,48,38,60,23,49,72,89,27,2,60,77,143
Pennsylvania6,6,Darnell Foreman,SO,G,Pennsylvania,Ivy,28,523,47,145,37,95,10,50,47,67,14,61,75,61,21,5,30,52,151
Pennsylvania7,7,Antonio Woods,SO,G,Pennsylvania,Ivy,13,402,53,137,40,84,13,53,20,38,5,24,29,43,11,1,24,25,139
Pennsylvania8,8,Max Rothschild,FR,F,Pennsylvania,Ivy,24,367,50,97,49,96,1,1,18,31,30,56,86,14,5,0,34,46,119
Pennsylvania9,9,Dan Dwyer,SO,F,Pennsylvania,Ivy,23,253,15,37,15,34,0,3,1,1,17,33,50,9,2,14,16,31,31
Pennsylvania10,10,Jamal Lewis,SR,G,Pennsylvania,Ivy,25,229,22,64,21,45,1,19,17,24,4,11,15,22,7,0,18,19,62
Pennsylvania11,11,Tyler Hamilton,FR,G,Pennsylvania,Ivy,18,140,11,37,7,19,4,18,11,15,3,16,19,7,10,1,10,24,37
Pennsylvania12,12,Mike Auger,SO,F,Pennsylvania,Ivy,15,107,19,33,18,31,1,2,3,8,7,22,29,2,1,1,9,23,42
Pennsylvania13,13,Collin McManus,FR,C,Pennsylvania,Ivy,9,23,3,7,3,7,0,0,3,4,3,3,6,0,0,1,1,1,9
Pennsylvania14,14,Dylan Jones,JR,F,Pennsylvania,Ivy,4,6,2,2,2,2,0,0,0,2,0,1,1,0,0,0,0,0,4
Pepperdine1,1,Stacy Davis,SR,F,Pepperdine,WCC,31,1057,156,344,126,256,30,88,129,170,78,200,278,63,18,19,71,76,471
Pepperdine2,2,Lamond Murray,JR,F,Pepperdine,WCC,31,973,198,422,171,350,27,72,81,106,45,120,165,28,27,16,39,68,504
Pepperdine3,3,Jeremy Major,JR,G,Pepperdine,WCC,31,896,105,226,62,127,43,99,54,96,11,83,94,115,37,9,45,79,307
Pepperdine4,4,Jett Raines,SR,F,Pepperdine,WCC,31,858,144,277,137,244,7,33,101,139,66,86,152,18,18,13,36,80,396
Pepperdine5,5,Kameron Edwards,FR,F,Pepperdine,WCC,31,745,81,184,80,174,1,10,61,100,50,79,129,40,24,10,53,67,224
Pepperdine6,6,Amadi Udenyi,JR,G,Pepperdine,WCC,31,726,49,149,31,78,18,71,32,57,6,59,65,139,29,1,47,60,148
Pepperdine7,7,A.J. John,SO,F,Pepperdine,WCC,30,368,24,59,24,54,0,5,12,17,20,57,77,6,7,15,22,62,60
Pepperdine8,8,Shawn Olden,SO,G,Pepperdine,WCC,9,184,23,50,10,21,13,29,11,15,2,17,19,7,8,2,10,16,70
Pepperdine9,9,A.J. Lapray,SO,G,Pepperdine,WCC,14,171,14,37,2,8,12,29,1,2,1,17,18,9,5,1,7,15,41
Pepperdine10,10,Jonathan Allen,JR,G,Pepperdine,WCC,15,109,3,9,1,4,2,5,2,4,4,11,15,5,4,0,4,12,10
Pepperdine11,11,Jake Johnson,SR,F,Pepperdine,WCC,12,58,4,6,4,6,0,0,4,10,2,4,6,1,0,1,2,21,12
Pepperdine12,12,Atif Russell,SR,G,Pepperdine,WCC,6,55,7,19,6,16,1,3,6,8,2,10,12,4,1,0,1,9,21
Pepperdine13,13,Ryan Keenan,FR,C,Pepperdine,WCC,9,39,2,3,2,3,0,0,1,4,2,2,4,1,0,0,3,7,5
Pepperdine14,14,Hakeem Anchrum,FR,F,Pepperdine,WCC,8,38,3,7,3,7,0,0,1,2,2,6,8,2,1,0,1,3,7
Pittsburgh1,1,James Robinson,SR,G,Pittsburgh,ACC,32,1017,110,288,71,171,39,117,71,93,13,81,94,162,38,8,41,65,330
Pittsburgh2,2,Jamel Artis,JR,F,Pittsburgh,ACC,32,959,161,341,115,212,46,129,94,121,40,115,155,98,18,8,78,57,462
Pittsburgh3,3,Michael Young,JR,F,Pittsburgh,ACC,32,946,186,345,182,333,4,12,136,174,75,148,223,77,11,16,79,51,512
Pittsburgh4,4,Chris Jones,SO,F,Pittsburgh,ACC,32,596,68,163,47,90,21,73,39,56,29,39,68,47,14,11,27,63,196
Pittsburgh5,5,Sterling Smith,SR,G,Pittsburgh,ACC,32,571,44,120,8,30,36,90,24,26,12,87,99,37,12,5,18,27,148
Pittsburgh6,6,Sheldon Jeter,JR,F,Pittsburgh,ACC,31,570,100,188,95,166,5,22,44,52,51,96,147,22,21,24,23,68,249
Pittsburgh7,7,RYan Luther,SO,F,Pittsburgh,ACC,31,417,63,108,55,90,8,18,26,39,44,48,92,14,13,11,29,51,160
Pittsburgh8,8,Rafael Maia,SR,F,Pittsburgh,ACC,32,383,24,52,24,51,0,1,18,31,48,66,114,18,14,6,14,60,66
Pittsburgh9,9,Cameron Johnson,FR,G,Pittsburgh,ACC,31,359,51,127,21,48,30,79,21,26,13,46,59,15,10,5,15,40,153
Pittsburgh10,10,Damon Wilson,FR,G,Pittsburgh,ACC,29,323,29,84,20,57,9,27,31,44,4,29,33,43,7,2,21,30,98
Pittsburgh11,11,Alonzo Nelson-Ododa,SR,F,Pittsburgh,ACC,30,238,17,36,17,36,0,0,6,15,25,21,46,4,1,22,10,37,40
Pittsburgh12,12,Jonathan Milligan,JR,G,Pittsburgh,ACC,4,39,4,7,1,3,3,4,2,2,0,1,1,3,0,0,2,7,13
Pittsburgh13,13,Mike Lecak,SR,G,Pittsburgh,ACC,11,21,1,7,1,2,0,5,0,0,0,0,0,1,0,0,3,4,2
Pittsburgh14,14,Ryan Seelye,FR,F,Pittsburgh,ACC,8,12,2,5,2,4,0,1,0,0,1,0,1,0,0,0,0,2,4
Portland1,1,Alec Wintering,JR,G,Portland,WCC,32,1010,182,410,139,302,43,108,177,227,18,88,106,158,49,1,102,87,584
Portland2,2,Bryce Pressley,SR,G,Portland,WCC,32,1005,170,364,107,200,63,164,67,89,41,105,146,78,41,17,36,64,470
Portland3,3,Gabe Taylor,SO,F,Portland,WCC,32,665,90,199,84,168,6,31,48,66,47,83,130,15,12,18,24,89,234
Portland4,4,D'Marques Tyson,SO,G,Portland,WCC,32,640,109,259,23,50,86,209,29,38,18,64,82,24,15,7,30,57,333
Portland5,5,Jason Todd,SO,G,Portland,WCC,29,599,52,119,32,62,20,57,19,25,19,47,66,28,22,7,23,25,143
Portland6,6,Jarrel Marshall,JR,G,Portland,WCC,31,581,86,236,64,165,22,71,47,61,26,82,108,38,12,22,34,56,241
Portland7,7,Jazz Johnson,FR,G,Portland,WCC,32,527,78,187,45,100,33,87,29,42,7,29,36,39,19,1,40,70,218
Portland8,8,Ray Barreno,JR,C,Portland,WCC,31,446,46,88,46,88,0,0,17,28,47,96,143,6,6,18,44,79,109
Portland9,9,Philipp Hartwich,SO,C,Portland,WCC,31,353,19,32,19,32,0,0,12,25,34,51,85,3,7,31,21,88,50
Portland10,10,Colin Russell,FR,F,Portland,WCC,30,241,7,20,7,20,0,0,3,12,30,27,57,5,10,4,14,41,17
Portland11,11,Max Livingston,SR,G,Portland,WCC,23,192,17,46,5,9,12,37,3,5,5,14,19,17,7,1,4,18,49
Portland12,12,Rashad Jackson,FR,G,Portland,WCC,21,141,11,47,8,27,3,20,5,11,4,20,24,9,6,1,9,20,30
Portland13,13,Xavier Hallinan,FR,G,Portland,WCC,10,25,1,5,0,2,1,3,2,4,0,3,3,5,2,0,2,3,5
Portland State1,1,Cameron Forte,SR,F,Portland State,Big Sky,31,907,244,421,243,419,1,2,107,194,106,182,288,80,30,15,99,65,596
Portland State2,2,Donivine Stewart,SR,G,Portland State,Big Sky,30,904,67,148,49,95,18,53,21,42,19,48,67,111,36,2,39,43,173
Portland State3,3,Calaen Robinson,JR,G,Portland State,Big Sky,31,884,107,273,49,103,58,170,43,54,10,85,95,101,55,1,59,69,315
Portland State4,4,Isaiah Pineiro,SO,F,Portland State,Big Sky,31,706,137,270,128,242,9,28,90,118,44,127,171,34,34,17,46,102,373
Portland State5,5,Zach Gengler,JR,G,Portland State,Big Sky,31,684,87,190,57,96,30,94,39,46,10,58,68,77,37,5,31,78,243
Portland State6,6,De'Sean Parsons,JR,G,Portland State,Big Sky,30,514,76,150,72,124,4,26,50,81,22,62,84,36,21,9,28,50,206
Portland State7,7,Collin Spickerman,SR,F,Portland State,Big Sky,27,506,71,138,71,137,0,1,15,23,42,58,100,26,19,45,25,68,157
Portland State8,8,Bryce White,JR,G,Portland State,Big Sky,13,342,52,131,37,87,15,44,30,40,4,31,35,25,17,4,18,21,149
Portland State9,9,Khari Holloway,JR,G,Portland State,Big Sky,25,331,25,74,12,35,13,39,16,19,5,25,30,22,8,0,17,36,79
Portland State10,10,Armani Collins,FR,G,Portland State,Big Sky,13,148,23,66,6,13,17,53,4,11,3,20,23,3,0,3,4,11,67
Portland State11,11,Evan Garrison,JR,G,Portland State,Big Sky,18,119,6,17,5,12,1,5,2,2,0,4,4,8,2,0,4,16,15
Portland State12,12,Namdi Okonkwo,JR,C,Portland State,Big Sky,15,92,7,14,7,14,0,0,5,11,5,24,29,1,1,10,9,18,19
Portland State13,13,Montie Leunen,JR,F,Portland State,Big Sky,10,54,4,9,3,5,1,4,1,2,3,2,5,3,3,1,3,10,10
Portland State14,14,Daniel Davydov,FR,G,Portland State,Big Sky,3,9,2,3,2,3,0,0,2,2,1,2,3,0,0,0,0,2,6
Prairie View1,1,Tevin Bellinger,JR,G,Prairie View,SWAC,31,842,109,308,80,188,29,120,67,79,19,63,82,48,37,0,85,58,314
Prairie View2,2,Admassu Williams,JR,F,Prairie View,SWAC,31,811,117,240,117,240,0,0,88,139,75,121,196,20,12,20,85,78,322
Prairie View3,3,Jayrn Johnson,JR,G,Prairie View,SWAC,31,806,131,323,76,174,55,149,67,91,26,57,83,34,53,15,55,93,384
Prairie View4,4,Zachary Hamilton,SO,F,Prairie View,SWAC,31,799,87,255,66,177,21,78,54,73,48,74,122,26,23,11,39,65,249
Prairie View5,5,Avery Lomax,SR,G,Prairie View,SWAC,30,745,26,113,25,88,1,25,34,46,14,59,73,60,42,0,55,76,87
Prairie View6,6,Karim York,SR,F,Prairie View,SWAC,28,577,81,179,79,157,2,22,36,60,34,82,116,16,9,13,55,77,200
Prairie View7,7,Ja'Donta Blakely,JR,G,Prairie View,SWAC,28,413,25,65,21,56,4,9,11,21,14,45,59,36,32,7,22,71,65
Prairie View8,8,Jordan Giddings,JR,G,Prairie View,SWAC,31,411,41,115,35,88,6,27,38,53,13,20,33,16,14,2,18,48,126
Prairie View9,9,Charleston Dobbs,SR,F,Prairie View,SWAC,31,268,11,30,11,30,0,0,10,17,19,26,45,0,3,6,6,47,32
Prairie View10,10,Nolan Wilson,SO,F,Prairie View,SWAC,29,209,2,10,2,10,0,0,9,18,11,23,34,5,5,7,5,36,13
Prairie View11,11,Tyler Miller,FR,F,Prairie View,SWAC,12,135,9,23,9,23,0,0,4,10,3,16,19,4,1,3,4,18,22
Prairie View12,12,Malik Amos,FR,G,Prairie View,SWAC,17,85,11,44,2,10,9,34,4,5,0,0,0,1,2,0,4,4,35
Prairie View13,13,Dominique Shaw,JR,G,Prairie View,SWAC,8,59,4,16,4,13,0,3,7,13,4,5,9,2,4,0,1,8,15
Prairie View14,14,Lavonne Davis,FR,F,Prairie View,SWAC,7,39,3,5,3,5,0,0,3,4,6,4,10,1,2,0,4,12,9
Presbyterian1,1,Reggie Dillard,SO,G,Presbyterian,Big South,31,931,91,248,47,109,44,139,36,55,14,119,133,64,27,8,66,70,262
Presbyterian2,2,DeSean Murray,SO,F,Presbyterian,Big South,31,902,232,427,232,420,0,7,163,211,74,154,228,53,62,17,95,94,627
Presbyterian3,3,Markus Terry,JR,G,Presbyterian,Big South,31,730,84,210,59,128,25,82,50,78,12,57,69,40,17,2,31,35,243
Presbyterian4,4,Ed Drew,JR,F,Presbyterian,Big South,31,605,72,157,70,147,2,10,61,73,59,86,145,12,11,4,29,70,207
Presbyterian5,5,Jaron Withers,SO,G,Presbyterian,Big South,31,471,22,79,14,42,8,37,14,28,9,46,55,34,22,2,26,51,66
Presbyterian6,6,Darius Moore,FR,G,Presbyterian,Big South,29,437,30,102,14,49,16,53,2,6,7,33,40,58,16,3,42,48,78
Presbyterian7,7,Davon Bell,SO,G,Presbyterian,Big South,26,403,25,65,24,56,1,9,20,26,4,30,34,37,15,4,28,47,71
Presbyterian8,8,Will Adams,JR,G,Presbyterian,Big South,27,391,33,100,10,22,23,78,11,14,12,29,41,15,9,2,15,23,100
Presbyterian9,9,Janeil Jenkins,SR,G,Presbyterian,Big South,22,374,35,70,22,41,13,29,36,40,4,18,22,22,11,0,20,31,119
Presbyterian10,10,Austin Venable,FR,C,Presbyterian,Big South,30,372,49,95,49,95,0,0,17,25,19,45,64,2,8,17,32,67,115
Presbyterian11,11,John Majors II,JR,F,Presbyterian,Big South,23,297,40,78,40,78,0,0,18,39,24,49,73,4,5,1,25,42,98
Presbyterian12,12,Ruben Arroyo-Felix,SO,F,Presbyterian,Big South,31,284,36,96,20,39,16,57,8,14,4,24,28,9,2,0,16,15,96
Presbyterian13,13,Stephen Osu,SO,C,Presbyterian,Big South,5,18,2,8,2,8,0,0,1,4,4,4,8,0,0,0,2,2,5
Presbyterian14,14,Harrison Burton,FR,F,Presbyterian,Big South,2,5,1,2,1,2,0,0,0,2,1,1,2,0,0,0,1,0,2
Presbyterian15,15,Charlie Inclan,JR,G,Presbyterian,Big South,2,5,2,6,2,5,0,1,0,0,0,0,0,0,1,0,0,0,4
Princeton1,1,Spencer Weisz,JR,F,Princeton,Ivy,28,882,102,240,43,90,59,150,36,45,22,124,146,110,25,3,38,59,299
Princeton2,2,Henry Caruso,JR,F,Princeton,Ivy,28,796,148,281,111,202,37,79,94,131,53,122,175,49,37,3,45,48,427
Princeton3,3,Steven Cook,JR,F,Princeton,Ivy,28,765,115,255,69,131,46,124,42,57,32,83,115,46,29,19,38,37,318
Princeton4,4,Amir Bell,SO,G,Princeton,Ivy,28,757,89,195,61,117,28,78,49,73,12,56,68,66,27,10,46,78,255
Princeton5,5,Devin Cannady,FR,G,Princeton,Ivy,28,607,97,193,43,80,54,113,76,86,19,51,70,34,31,5,33,55,324
Princeton6,6,Pete Miller,JR,F,Princeton,Ivy,28,591,81,156,81,156,0,0,24,47,56,117,173,43,12,34,37,61,186
Princeton7,7,Myles Stephens,FR,G,Princeton,Ivy,28,405,53,111,44,80,9,31,36,56,15,49,64,11,12,13,26,31,151
Princeton8,8,Alec Brennan,SO,F,Princeton,Ivy,28,262,30,56,22,37,8,19,9,20,20,43,63,15,12,12,16,52,77
Princeton9,9,Noah Bramlage,FR,F,Princeton,Ivy,17,118,13,37,9,22,4,15,12,18,6,12,18,11,3,1,8,11,42
Princeton10,10,Jackson Forbes,SO,F,Princeton,Ivy,20,115,12,38,3,5,9,33,4,5,6,12,18,9,3,0,7,13,37
Princeton11,11,Khyan Rayner,JR,G,Princeton,Ivy,18,113,10,32,4,16,6,16,9,14,3,8,11,5,2,0,3,12,35
Princeton12,12,Aaron Young,SO,G,Princeton,Ivy,19,86,7,17,2,3,5,14,8,11,2,6,8,9,2,0,3,10,27
Princeton13,13,Mike LeBlanc,SO,F,Princeton,Ivy,14,80,7,24,2,6,5,18,1,1,1,10,11,5,4,0,3,8,20
Princeton14,14,Mike Washington,SR,G,Princeton,Ivy,17,62,7,17,6,11,1,6,0,0,0,12,12,5,0,0,6,2,15
Providence1,1,Ben Bentil,SO,F,Providence,Big East,33,1126,232,495,184,351,48,144,186,236,90,166,256,37,27,36,66,90,698
Providence2,2,Rodney Bullock,SO,F,Providence,Big East,33,1072,139,309,107,216,32,93,72,100,75,151,226,33,21,44,59,99,382
Providence3,3,Kris Dunn,JR,G,Providence,Big East,31,1035,169,382,134,279,35,103,124,180,35,134,169,199,79,20,110,85,497
Providence4,4,Junior Lomomba,JR,G,Providence,Big East,33,823,62,153,47,107,15,46,43,64,29,57,86,66,13,1,41,60,182
Providence5,5,Kyron Cartwright,SO,G,Providence,Big East,33,796,67,188,48,135,19,53,35,51,10,63,73,132,31,2,48,68,188
Providence6,6,Jalen Lindsey,SO,G,Providence,Big East,31,787,77,198,39,63,38,135,33,45,44,93,137,23,17,3,22,46,225
Providence7,7,Ryan Fazekas,FR,G,Providence,Big East,27,525,47,129,13,30,34,99,14,19,20,46,66,9,11,6,8,36,142
Providence8,8,Drew Edwards,FR,G,Providence,Big East,31,313,24,76,14,40,10,36,17,28,16,34,50,19,12,4,6,40,75
Providence9,9,Quadree Smith,FR,F,Providence,Big East,18,93,10,19,10,19,0,0,12,15,6,13,19,1,3,1,5,19,32
Providence10,10,Ricky Council II,FR,G,Providence,Big East,13,44,4,18,1,1,3,17,3,3,0,6,6,1,2,2,4,3,14
Providence11,11,Tom Planek,SO,F,Providence,Big East,13,31,2,3,2,3,0,0,2,3,2,0,2,1,1,0,0,4,6
Purdue1,1,Vince Edwards,SO,F,Purdue,Big Ten,34,920,132,293,89,187,43,106,66,81,60,115,175,99,18,11,54,74,373
Purdue2,2,Rapheal Davis,SR,G,Purdue,Big Ten,30,881,81,212,50,125,31,87,57,78,22,95,117,68,13,13,40,56,250
Purdue3,3,Caleb Swanigan,FR,F,Purdue,Big Ten,33,852,127,277,106,205,21,72,67,94,53,219,272,61,12,8,87,73,342
Purdue4,4,A.J. Hammons,SR,C,Purdue,Big Ten,32,775,194,326,188,315,6,11,84,119,73,182,255,34,9,78,64,77,478
Purdue5,5,P.J. Thompson,SO,G,Purdue,Big Ten,34,761,55,123,22,46,33,77,51,62,20,51,71,91,23,0,19,51,194
Purdue6,6,Dakota Mathias,SO,G,Purdue,Big Ten,34,631,61,148,20,42,41,106,16,18,2,70,72,78,11,2,20,49,179
Purdue7,7,Johnny Hill,SR,G,Purdue,Big Ten,34,605,56,104,54,95,2,9,59,71,42,49,91,79,35,11,44,58,173
Purdue8,8,Isaac Haas,SO,C,Purdue,Big Ten,34,488,124,209,124,209,0,0,87,122,40,88,128,15,4,26,38,57,335
Purdue9,9,Ryan Cline,FR,G,Purdue,Big Ten,34,458,43,119,1,12,42,107,6,11,1,40,41,45,7,1,11,41,134
Purdue10,10,Kendall Stephens,JR,G,Purdue,Big Ten,24,340,48,140,10,20,38,120,12,20,5,25,30,21,10,4,12,28,146
Purdue11,11,Jacquil Taylor,SO,F,Purdue,Big Ten,13,60,9,18,7,13,2,5,4,9,9,11,20,3,2,4,5,14,24
Purdue12,12,Grady Eifert,FR,F,Purdue,Big Ten,11,28,2,7,2,6,0,1,3,5,5,3,8,0,1,0,2,1,7
Purdue13,13,Stephen Toyra,SR,G,Purdue,Big Ten,11,26,2,4,2,2,0,2,4,5,1,3,4,4,0,0,5,5,8
Quinnipiac1,1,Gio McLean,SR,G,Quinnipiac,MAAC,29,893,122,342,68,180,54,162,77,99,29,107,136,95,21,1,86,70,375
Quinnipiac2,2,James Ford,SR,G,Quinnipiac,MAAC,30,838,66,206,32,101,34,105,39,69,39,77,116,48,20,2,48,73,205
Quinnipiac3,3,Daniel Harris,JR,G,Quinnipiac,MAAC,30,802,104,253,34,81,70,172,27,40,33,97,130,60,34,10,48,51,305
Quinnipiac4,4,Abdulai Bundu,FR,F,Quinnipiac,MAAC,30,696,82,171,82,171,0,0,57,94,105,93,198,10,7,13,36,60,221
Quinnipiac5,5,Chaise Daniels,SO,F,Quinnipiac,MAAC,23,596,92,234,92,233,0,1,41,66,48,94,142,23,8,39,54,72,225
Quinnipiac6,6,Donovan Smith,JR,F,Quinnipiac,MAAC,30,567,90,222,90,221,0,1,36,48,58,116,174,17,11,53,46,74,216
Quinnipiac7,7,Ayron Hutton,SO,G,Quinnipiac,MAAC,29,531,44,151,13,65,31,86,27,45,20,60,80,56,14,1,50,50,146
Quinnipiac8,8,Dimitri Floras,SO,G,Quinnipiac,MAAC,29,404,38,139,17,69,21,70,17,26,17,27,44,50,16,0,33,45,114
Quinnipiac9,9,Samuel Dingba,SO,F,Quinnipiac,MAAC,27,264,17,46,17,46,0,0,13,24,33,35,68,2,2,15,17,41,47
Quinnipiac10,10,Will Simonton,SR,C,Quinnipiac,MAAC,22,226,20,43,19,42,1,1,6,12,18,24,42,12,5,7,16,48,47
Quinnipiac11,11,Andrew Robinson,FR,G,Quinnipiac,MAAC,24,180,18,67,4,8,14,59,1,2,11,13,24,3,3,0,6,16,51
Quinnipiac12,12,Alain Chigha,SO,F,Quinnipiac,MAAC,14,56,3,13,1,7,2,6,3,7,9,7,16,1,5,0,6,8,11
Quinnipiac13,13,Aaron Robinson,FR,G,Quinnipiac,MAAC,8,20,2,10,0,2,2,8,0,0,1,0,1,0,0,0,0,3,6
Radford1,1,Rashun Davis,SR,G,Radford,Big South,31,975,156,353,117,243,39,110,84,117,11,80,91,149,60,2,90,77,435
Radford2,2,Cameron Jones,SR,G,Radford,Big South,31,894,171,387,96,192,75,195,45,59,46,93,139,42,19,8,55,57,462
Radford3,3,"Ed Polite, Jr.",FR,F,Radford,Big South,31,784,105,194,105,194,0,0,60,114,100,127,227,25,26,55,53,80,270
Radford4,4,YaYa Anderson,SR,G,Radford,Big South,26,713,63,182,29,73,34,109,24,27,18,50,68,39,14,1,22,34,184
Radford5,5,Brandon Holcomb,SR,C,Radford,Big South,31,651,79,137,79,137,0,0,35,60,45,109,154,27,21,34,55,79,193
Radford6,6,Kion Brown,SR,F,Radford,Big South,31,527,63,129,63,129,0,0,26,46,37,67,104,13,3,12,30,67,152
Radford7,7,Justin Cousin,SO,G,Radford,Big South,31,513,58,154,23,49,35,105,12,19,12,29,41,30,12,1,24,43,163
Radford8,8,Taj Owens,SR,G,Radford,Big South,31,390,41,94,33,73,8,21,30,35,8,37,45,48,16,1,23,41,120
Radford9,9,Darius Bolstad,FR,C,Radford,Big South,31,298,39,65,39,65,0,0,14,25,36,55,91,11,4,16,22,48,92
Radford10,10,Christian Lutete,FR,F,Radford,Big South,27,255,28,81,14,28,14,53,8,12,17,43,60,11,1,2,14,17,78
Radford11,11,Caleb Tanner,FR,G,Radford,Big South,20,126,20,59,2,10,18,49,1,2,0,4,4,5,1,1,4,4,59
Radford12,12,Sterling Christy,FR,F,Radford,Big South,9,126,10,25,10,21,0,4,8,17,7,16,23,5,3,3,6,18,28
Radford13,13,Kyle Gonzalez,SR,G,Radford,Big South,12,50,5,8,4,4,1,4,4,7,4,7,11,3,2,2,5,6,15
Radford14,14,Devin Cooper,FR,G,Radford,Big South,13,47,6,17,4,9,2,8,1,1,1,1,2,2,1,0,2,9,15
Rhode Island1,1,Jared Terrell,SO,G,Rhode Island,A-10,32,1137,148,373,107,255,41,118,99,132,14,95,109,82,38,8,62,80,436
Rhode Island2,2,Four McGlynn,SR,G,Rhode Island,A-10,32,1074,104,293,28,74,76,219,86,98,7,72,79,45,20,4,46,76,370
Rhode Island3,3,Jarvis Garrett,SO,G,Rhode Island,A-10,31,1063,135,323,91,218,44,105,74,106,29,87,116,146,34,4,75,59,388
Rhode Island4,4,Kuran Iverson,JR,F,Rhode Island,A-10,28,759,109,228,93,187,16,41,40,79,58,142,200,43,22,33,62,83,274
Rhode Island5,5,Hassan Martin,JR,F,Rhode Island,A-10,26,727,125,219,124,215,1,4,62,101,55,90,145,24,18,65,48,78,313
Rhode Island6,6,Earl Watson,SR,C,Rhode Island,A-10,32,615,67,111,67,111,0,0,44,72,57,108,165,7,10,31,26,92,178
Rhode Island7,7,Christion Thompson,FR,G,Rhode Island,A-10,29,525,35,98,15,37,20,61,24,40,23,55,78,32,18,4,24,68,114
Rhode Island8,8,Nicola Akele,FR,F,Rhode Island,A-10,32,434,35,77,21,43,14,34,5,18,27,44,71,12,10,9,10,55,89
Rhode Island9,9,Andre Berry,SO,F,Rhode Island,A-10,16,110,21,31,21,31,0,0,9,13,15,24,39,0,0,1,5,11,51
Rhode Island10,10,Shane Plunkett,SR,G,Rhode Island,A-10,8,10,1,4,0,2,1,2,0,2,0,0,0,0,0,0,0,2,3
Rhode Island11,11,Rory Temkin,JR,G,Rhode Island,A-10,8,8,2,3,2,3,0,0,0,1,0,2,2,0,0,0,0,1,4
Rice1,1,Egor Koulechov,SO,G,Rice,CUSA,32,1101,175,420,95,187,80,233,106,123,48,176,224,42,28,6,45,69,536
Rice2,2,Max Guercy,SR,G,Rice,CUSA,32,1074,60,159,41,99,19,60,88,105,20,70,90,182,30,1,91,70,227
Rice3,3,Marcus Evans,FR,G,Rice,CUSA,32,1073,224,475,171,304,53,171,186,233,28,100,128,91,70,6,100,92,687
Rice4,4,Connor Cashaw,FR,G,Rice,CUSA,32,956,94,222,50,107,44,115,37,62,33,106,139,38,30,2,41,67,269
Rice5,5,Bishop Mency,SO,G,Rice,CUSA,32,743,41,128,18,35,23,93,7,19,22,61,83,27,12,11,27,53,112
Rice6,6,Marquez Letcher-Ellis,FR,F,Rice,CUSA,32,690,110,214,102,173,8,41,98,152,50,108,158,21,25,36,59,101,326
Rice7,7,Andrew Drone,JR,C,Rice,CUSA,32,623,97,154,97,154,0,0,43,62,48,83,131,15,8,23,35,76,237
Rice8,8,Amir Smith,FR,F,Rice,CUSA,24,118,9,16,9,16,0,0,7,13,8,12,20,1,2,3,6,29,25
Rice9,9,Oliver Xu,SO,G,Rice,CUSA,11,29,2,6,1,3,1,3,1,2,1,1,2,1,0,0,6,4,6
Rice10,10,Harrison Brown,FR,G,Rice,CUSA,6,5,1,3,1,3,0,0,0,0,1,1,2,0,0,0,0,0,2
Richmond1,1,ShawnDre' Jones,JR,G,Richmond,A-10,31,1073,154,354,94,202,60,152,93,113,17,53,70,114,23,2,50,82,461
Richmond2,2,Terry Allen,SR,F,Richmond,A-10,32,1065,192,391,168,313,24,78,142,195,66,179,245,69,52,19,59,83,550
Richmond3,3,T.J. Cline,JR,F,Richmond,A-10,32,961,228,408,184,289,44,119,88,137,38,129,167,122,21,3,72,87,588
Richmond4,4,Trey Davis,SR,F,Richmond,A-10,32,943,62,144,49,100,13,44,26,57,21,100,121,104,37,8,41,87,163
Richmond5,5,Marshall Wood,JR,F,Richmond,A-10,30,701,88,200,30,56,58,144,25,48,29,88,117,14,15,14,23,68,259
Richmond6,6,Khwan Fore,FR,G,Richmond,A-10,32,651,81,156,69,123,12,33,33,57,26,72,98,46,38,2,31,73,207
Richmond7,7,Deion Taylor,SR,F,Richmond,A-10,30,650,46,82,37,52,9,30,13,27,17,85,102,48,17,20,26,75,114
Richmond8,8,Julius Johnson,FR,G,Richmond,A-10,26,207,13,46,7,13,6,33,4,5,6,16,22,6,1,4,4,30,36
Richmond9,9,Jesse Pistokache,FR,G,Richmond,A-10,15,104,11,28,5,10,6,18,1,6,2,3,5,5,0,2,6,10,29
Richmond10,10,John Moran,SR,G,Richmond,A-10,12,49,7,18,0,0,7,18,0,0,0,4,4,2,2,0,3,5,21
Richmond11,11,Josh Jones,JR,G,Richmond,A-10,1,38,3,9,3,8,0,1,2,2,0,2,2,0,2,0,1,3,8
Richmond12,12,Paul Friendshuh,FR,F,Richmond,A-10,8,26,4,7,4,6,0,1,3,4,0,3,3,1,1,0,3,6,11
Richmond13,13,Joe Kirby,SO,G,Richmond,A-10,3,6,1,4,0,1,1,3,0,0,2,2,4,0,1,0,0,0,3
Rider1,1,Teddy Okereafor,SR,G,Rider,MAAC,33,1168,121,303,75,150,46,153,112,152,13,126,139,150,37,7,98,47,400
Rider2,2,Jimmie Taylor,JR,G,Rider,MAAC,33,981,101,257,52,125,49,132,52,73,26,118,144,32,23,4,41,83,303
Rider3,3,Kahlil Thomas,JR,F,Rider,MAAC,33,909,152,269,151,265,1,4,81,138,91,172,263,27,12,24,57,76,386
Rider4,4,Xavier Lundy,JR,F,Rider,MAAC,33,799,136,273,106,186,30,87,44,67,49,85,134,27,19,30,49,76,346
Rider5,5,Zedric Sadler,SR,G,Rider,MAAC,29,717,54,173,35,84,19,89,27,33,11,71,82,59,38,18,35,55,154
Rider6,6,Shawn Valentine,SR,F,Rider,MAAC,33,684,50,122,33,72,17,50,33,51,26,74,100,32,24,15,40,75,150
Rider7,7,Khalil Alford,SR,G,Rider,MAAC,32,621,82,199,63,136,19,63,36,49,36,61,97,24,8,16,36,80,219
Rider8,8,Kealen Ives,FR,G,Rider,MAAC,32,583,47,147,24,81,23,66,35,45,7,49,56,62,23,1,41,54,152
Rider9,9,Kenny Grant,SO,F,Rider,MAAC,10,115,15,25,15,25,0,0,6,10,7,23,30,2,2,4,8,24,36
Rider10,10,Lacey James,FR,F,Rider,MAAC,12,60,4,14,4,14,0,0,4,11,8,5,13,0,2,3,2,10,12
Rider11,11,Josh Williams,FR,G,Rider,MAAC,9,41,5,15,5,12,0,3,3,7,1,9,10,1,1,2,5,5,13
Rider12,12,Anthony Durham,SO,G,Rider,MAAC,5,22,2,6,2,6,0,0,2,2,0,1,1,0,0,0,1,2,6
Robert Morris1,1,Kavon Stewart,SO,G,Robert Morris,NEC,31,960,93,267,81,215,12,52,88,149,16,54,70,145,55,1,99,85,286
Robert Morris2,2,Rodney Pryor,JR,G,Robert Morris,NEC,29,931,178,410,129,241,49,169,117,136,52,179,231,48,42,25,83,73,522
Robert Morris3,3,Isaiah Still,FR,G,Robert Morris,NEC,29,880,84,238,53,131,31,107,88,128,18,91,109,47,17,7,50,66,287
Robert Morris4,4,Matty McConnell,FR,G,Robert Morris,NEC,29,862,68,218,27,64,41,154,19,28,15,56,71,66,57,6,27,47,196
Robert Morris5,5,Billy Giles,JR,F,Robert Morris,NEC,32,803,120,198,120,194,0,4,41,80,65,97,162,12,20,25,39,88,281
Robert Morris6,6,Elijah Minnie,FR,F,Robert Morris,NEC,22,648,97,227,61,117,36,110,33,43,34,111,145,21,19,42,52,59,263
Robert Morris7,7,Steven Whitley,FR,G,Robert Morris,NEC,31,519,38,95,32,62,6,33,20,37,8,47,55,37,24,3,43,52,102
Robert Morris8,8,Andre Frederick,FR,F,Robert Morris,NEC,27,361,28,45,28,45,0,0,5,17,18,20,38,3,14,18,19,43,61
Robert Morris9,9,Jordan Lester,FR,G,Robert Morris,NEC,22,240,12,36,10,24,2,12,3,4,2,19,21,17,9,0,16,19,29
Robert Morris10,10,Conrad Stephens,SO,F,Robert Morris,NEC,14,152,15,26,15,26,0,0,6,9,17,17,34,2,6,0,8,15,36
Robert Morris11,11,Aaron Tate,JR,F,Robert Morris,NEC,3,46,6,13,6,13,0,0,0,0,4,4,8,1,2,0,1,4,12
Robert Morris12,12,Seth Rouse,FR,F,Robert Morris,NEC,3,7,1,1,1,1,0,0,2,2,1,0,1,0,0,0,0,0,4
Robert Morris13,13,Anthony Pugh,FR,G,Robert Morris,NEC,3,7,1,1,0,0,1,1,0,0,0,0,0,0,0,0,0,0,3
Rutgers1,1,Corey Sanders,FR,G,Rutgers,Big Ten,27,905,156,369,115,239,41,130,77,108,13,75,88,115,48,5,83,47,430
Rutgers2,2,Bishop Daniels,SR,G,Rutgers,Big Ten,32,869,111,280,99,238,12,42,46,67,19,102,121,96,34,14,87,58,280
Rutgers3,3,Mike Williams,SO,G,Rutgers,Big Ten,32,867,128,337,78,179,50,158,86,108,32,80,112,36,33,14,49,71,392
Rutgers4,4,D.J. Foreman,SO,F,Rutgers,Big Ten,31,820,91,190,88,184,3,6,60,109,49,141,190,21,21,19,60,93,245
Rutgers5,5,Jonathan Laurent,FR,F,Rutgers,Big Ten,27,655,79,170,73,145,6,25,54,74,32,106,138,23,13,5,43,61,218
Rutgers6,6,Greg Lewis,SR,F,Rutgers,Big Ten,31,654,52,145,52,145,0,0,19,43,56,102,158,20,11,33,35,78,123
Rutgers7,7,Omari Grier,SR,G,Rutgers,Big Ten,31,652,79,180,45,96,34,84,45,54,11,35,46,23,12,2,32,36,237
Rutgers8,8,Justin Goode,FR,G,Rutgers,Big Ten,30,431,20,55,8,16,12,39,14,17,3,32,35,20,8,1,10,37,66
Rutgers9,9,Ibrahima Diallo,FR,F,Rutgers,Big Ten,14,219,21,46,21,46,0,0,9,20,16,31,47,3,2,7,12,41,51
Rutgers10,10,DeShawn Freeman,JR,F,Rutgers,Big Ten,8,216,39,72,39,70,0,2,23,34,15,24,39,9,11,8,14,19,101
Rutgers11,11,Jake Dadika,SO,G,Rutgers,Big Ten,17,81,3,10,2,4,1,6,2,4,0,5,5,6,0,0,5,8,9
Rutgers12,12,Khalil Batie,JR,G,Rutgers,Big Ten,13,65,4,15,2,8,2,7,0,2,2,8,10,5,1,4,1,8,10
Rutgers13,13,Jalen Hyde,SR,G,Rutgers,Big Ten,16,41,2,9,2,5,0,4,0,0,1,7,8,0,1,1,3,5,4
Sacramento State1,1,Marcus Graves,SO,G,Sacramento State,Big Sky,31,1067,127,305,97,197,30,108,94,138,13,107,120,136,49,1,65,95,378
Sacramento State2,2,Justin Strings,SO,F,Sacramento State,Big Sky,31,976,174,354,114,202,60,152,74,96,51,158,209,30,20,25,29,86,482
Sacramento State3,3,Nick Hornsby,JR,F,Sacramento State,Big Sky,30,835,90,208,88,195,2,13,51,77,65,142,207,49,36,21,56,94,233
Sacramento State4,4,Dreon Barlett,SR,G,Sacramento State,Big Sky,30,786,71,184,18,46,53,138,31,35,9,87,96,25,14,9,24,69,226
Sacramento State5,5,Cody Demps,SR,G,Sacramento State,Big Sky,22,673,94,219,77,166,17,53,58,90,31,69,100,103,17,7,64,61,263
Sacramento State6,6,Eric Stuteville,JR,C,Sacramento State,Big Sky,31,628,100,177,100,177,0,0,48,90,53,93,146,9,4,58,44,86,248
Sacramento State7,7,Jeff Wu,FR,G,Sacramento State,Big Sky,31,530,71,164,42,78,29,86,22,39,4,36,40,30,15,4,30,48,193
Sacramento State8,8,Jiday Ugbaja,SO,G,Sacramento State,Big Sky,30,290,31,72,26,54,5,18,19,28,10,14,24,25,14,0,22,48,86
Sacramento State9,9,Trevis Jackson,JR,G,Sacramento State,Big Sky,31,169,4,12,4,6,0,6,10,14,4,8,12,16,2,0,9,15,18
Sacramento State10,10,Grant Dressler,FR,F,Sacramento State,Big Sky,19,110,8,36,1,12,7,24,7,8,4,12,16,7,2,0,6,6,30
Sacramento State11,11,Mason Stuteville,SO,F,Sacramento State,Big Sky,17,94,15,40,9,20,6,20,2,4,8,17,25,3,1,3,4,13,38
Sacramento State12,12,James Herrick,SO,C,Sacramento State,Big Sky,15,67,5,13,5,13,0,0,5,8,7,12,19,1,1,2,8,10,15
Sacred Heart1,1,Cane Broome,SO,G,Sacred Heart,NEC,30,1126,236,530,170,318,66,212,156,203,17,131,148,88,51,0,115,71,694
Sacred Heart2,2,Quincy McKnight,FR,G,Sacred Heart,NEC,27,867,119,275,109,235,10,40,61,108,28,114,142,68,42,11,75,84,309
Sacred Heart3,3,Jordan Allen,SR,F,Sacred Heart,NEC,30,787,118,219,117,216,1,3,70,117,76,85,161,60,32,5,56,113,307
Sacred Heart4,4,Tevin Falzon,SR,F,Sacred Heart,NEC,25,762,81,217,63,155,18,62,92,115,94,113,207,38,8,36,34,71,272
Sacred Heart5,5,Sean Hoehn,FR,G,Sacred Heart,NEC,30,677,49,114,28,55,21,59,25,35,13,42,55,57,28,0,47,66,144
Sacred Heart6,6,Matej Buovac,JR,F,Sacred Heart,NEC,27,655,53,150,17,43,36,107,29,34,21,63,84,16,8,5,17,45,171
Sacred Heart7,7,Chris Robinson,SO,G,Sacred Heart,NEC,23,475,41,118,24,58,17,60,12,23,18,66,84,17,6,2,24,46,111
Sacred Heart8,8,Eyimofe Edukugho,SR,F,Sacred Heart,NEC,27,334,59,112,59,112,0,0,22,36,31,43,74,8,7,9,32,68,140
Sacred Heart9,9,Jermaine Ukaegbu,FR,F,Sacred Heart,NEC,21,140,14,26,14,25,0,1,4,11,13,20,33,5,5,6,6,23,32
Sacred Heart10,10,Cole Walton,JR,C,Sacred Heart,NEC,15,112,4,14,4,14,0,0,3,4,9,11,20,2,2,2,4,20,11
Sacred Heart11,11,Filip Nowicki,SO,C,Sacred Heart,NEC,11,108,11,19,11,19,0,0,4,9,7,15,22,4,1,1,14,17,26
Saint Francis (PA)1,1,Ronnie Drinnon,SR,F,Saint Francis (PA),NEC,30,977,150,309,136,263,14,46,84,143,112,217,329,50,21,3,52,73,398
Saint Francis (PA)2,2,Greg Brown,SR,G,Saint Francis (PA),NEC,28,960,129,323,94,224,35,99,66,93,15,75,90,92,24,7,71,72,359
Saint Francis (PA)3,3,Ben Millaud-Meunier,SR,G,Saint Francis (PA),NEC,30,816,107,274,27,75,80,199,81,89,11,75,86,54,20,3,40,42,375
Saint Francis (PA)4,4,Malik Harmon,JR,G,Saint Francis (PA),NEC,27,803,60,201,22,85,38,116,58,83,11,58,69,80,26,0,48,49,216
Saint Francis (PA)5,5,Josh Nebo,FR,F,Saint Francis (PA),NEC,30,684,56,115,56,115,0,0,36,69,56,96,152,14,7,56,26,75,148
Saint Francis (PA)6,6,Basil Thompson,SO,F,Saint Francis (PA),NEC,28,490,66,170,64,150,2,20,70,93,39,77,116,14,7,13,52,57,204
Saint Francis (PA)7,7,Isaiah Blackmon,FR,G,Saint Francis (PA),NEC,19,429,70,130,58,100,12,30,32,45,27,38,65,24,19,5,28,39,184
Saint Francis (PA)8,8,Georgios Angelou,JR,G,Saint Francis (PA),NEC,28,394,30,63,3,6,27,57,14,14,4,25,29,13,5,1,15,29,101
Saint Francis (PA)9,9,Patrick Wrencher,JR,F,Saint Francis (PA),NEC,24,178,18,33,18,33,0,0,5,6,12,13,25,3,3,4,9,21,41
Saint Francis (PA)10,10,Jamaal King,FR,G,Saint Francis (PA),NEC,17,152,13,37,7,17,6,20,3,4,4,8,12,10,5,1,8,23,35
Saint Francis (PA)11,11,Ifeanyi Umezurike,FR,F,Saint Francis (PA),NEC,11,85,12,24,12,24,0,0,8,17,13,16,29,0,0,2,8,28,32
Saint Francis (PA)12,12,Scott Meredith,FR,G,Saint Francis (PA),NEC,13,53,2,13,0,0,2,13,0,0,2,4,6,2,2,0,2,3,6
Saint Francis (PA)13,13,Andre Wolford,FR,G,Saint Francis (PA),NEC,7,13,3,5,1,1,2,4,1,2,1,1,2,0,0,0,1,1,9
Saint Joseph's1,1,DeAndre Bembry,JR,F,Saint Joseph's,A-10,34,1261,225,468,194,348,31,120,107,167,47,214,261,153,46,28,69,82,588
Saint Joseph's2,2,Isaiah Miles,SR,F,Saint Joseph's,A-10,34,1181,214,405,152,245,62,160,136,154,81,196,277,29,20,34,39,96,626
Saint Joseph's3,3,Aaron Brown,SR,G,Saint Joseph's,A-10,34,897,126,283,94,190,32,93,66,91,26,88,114,45,13,1,44,59,350
Saint Joseph's4,4,Shavar Newkirk,SO,G,Saint Joseph's,A-10,34,802,86,226,64,153,22,73,82,113,14,67,81,94,28,5,52,32,276
Saint Joseph's5,5,James Demery,SO,F,Saint Joseph's,A-10,34,735,103,202,93,163,10,39,60,93,36,89,125,17,13,4,25,54,276
Saint Joseph's6,6,Lamarr Kimble,FR,G,Saint Joseph's,A-10,34,608,66,164,39,90,27,74,44,60,9,41,50,87,15,4,40,53,203
Saint Joseph's7,7,Papa Ndao,SR,F,Saint Joseph's,A-10,28,554,49,126,12,26,37,100,13,19,15,75,90,28,15,15,25,74,148
Saint Joseph's8,8,Pierfrancesco Oliva,FR,F,Saint Joseph's,A-10,31,518,44,118,30,67,14,51,23,42,30,85,115,56,21,20,24,54,125
Saint Joseph's9,9,Javon Baumann,JR,F,Saint Joseph's,A-10,21,94,3,8,3,8,0,0,5,12,9,13,22,2,2,3,1,14,11
Saint Joseph's10,10,Chris Clover,FR,G,Saint Joseph's,A-10,19,65,2,21,0,8,2,13,4,6,0,4,4,1,1,0,4,10,10
Saint Joseph's11,11,Markell Lodge,FR,F,Saint Joseph's,A-10,13,58,4,5,4,5,0,0,2,4,6,6,12,0,0,1,3,9,10
Saint Joseph's12,12,Brendan Casper,JR,F,Saint Joseph's,A-10,11,19,3,6,2,4,1,2,1,2,2,3,5,1,1,0,3,0,8
Saint Joseph's13,13,Jai Williams,SO,F,Saint Joseph's,A-10,4,12,1,2,1,2,0,0,2,2,2,2,4,0,0,0,2,4,4
Saint Louis1,1,Ash Yacoubou,SR,G,Saint Louis,A-10,32,963,139,322,103,206,36,116,35,69,36,147,183,56,23,10,63,86,349
Saint Louis2,2,Mike Crawford,JR,G,Saint Louis,A-10,32,861,110,257,67,130,43,127,67,84,17,96,113,31,23,1,38,59,330
Saint Louis3,3,Reggie Agbeko,JR,F,Saint Louis,A-10,32,779,81,142,81,142,0,0,41,65,60,137,197,9,17,12,48,73,203
Saint Louis4,4,Davell Roby,SO,G,Saint Louis,A-10,31,633,56,141,27,67,29,74,53,72,7,66,73,50,18,3,43,69,194
Saint Louis5,5,Miles Reynolds,SO,G,Saint Louis,A-10,29,593,65,149,59,127,6,22,102,130,9,54,63,73,29,3,51,63,238
Saint Louis6,6,Jermaine Bishop,FR,G,Saint Louis,A-10,27,562,80,197,51,108,29,89,51,59,7,46,53,62,10,2,45,33,240
Saint Louis7,7,Milik Yarbrough,SO,F,Saint Louis,A-10,27,517,74,187,59,145,15,42,46,77,21,104,125,38,11,7,48,45,209
Saint Louis8,8,Marcus Bartley,SO,G,Saint Louis,A-10,32,467,38,100,9,27,29,73,17,18,1,23,24,40,14,3,21,71,122
Saint Louis9,9,Aaron Hines,JR,G,Saint Louis,A-10,23,395,34,117,29,83,5,34,19,26,4,32,36,47,13,0,22,42,92
Saint Louis10,10,Austin Gillmann,SO,C,Saint Louis,A-10,16,280,19,48,12,25,7,23,10,14,9,21,30,14,6,11,11,41,55
Saint Louis11,11,Matt Neufeld,FR,C,Saint Louis,A-10,25,242,18,40,18,35,0,5,9,24,7,23,30,2,7,8,20,29,45
Saint Louis12,12,Brett Jolly,SO,F,Saint Louis,A-10,18,157,10,26,10,24,0,2,9,15,6,18,24,4,4,6,12,35,29
Saint Mary's (CA)1,1,Emmett Naar,SO,G,Saint Mary's (CA),WCC,32,1185,157,315,104,196,53,119,90,103,21,95,116,200,39,5,73,40,457
Saint Mary's (CA)2,2,Joe Rahon,JR,G,Saint Mary's (CA),WCC,32,1177,135,305,93,190,42,115,33,61,11,133,144,177,43,14,57,65,345
Saint Mary's (CA)3,3,Calvin Hermanson,SO,F,Saint Mary's (CA),WCC,32,902,128,279,57,105,71,174,38,53,25,67,92,23,8,8,20,58,365
Saint Mary's (CA)4,4,Dane Pineau,JR,F,Saint Mary's (CA),WCC,32,840,158,241,156,232,2,9,40,77,89,171,260,48,26,47,34,88,358
Saint Mary's (CA)5,5,Evan Fitzner,FR,C,Saint Mary's (CA),WCC,32,744,103,211,52,90,51,121,29,38,33,104,137,27,9,14,28,59,286
Saint Mary's (CA)6,6,Kyle Clark,FR,F,Saint Mary's (CA),WCC,31,554,48,105,22,35,26,70,32,45,17,56,73,9,8,6,27,60,154
Saint Mary's (CA)7,7,Jock Landale,SO,C,Saint Mary's (CA),WCC,32,472,92,152,91,151,1,1,67,86,37,94,131,21,8,12,33,70,252
Saint Mary's (CA)8,8,Stefan Gonzalez,FR,G,Saint Mary's (CA),WCC,32,324,39,77,5,10,34,67,10,14,3,49,52,12,8,0,11,24,122
Saint Mary's (CA)9,9,Jack Biebel,JR,G,Saint Mary's (CA),WCC,21,72,2,5,2,2,0,3,2,5,1,8,9,16,4,0,5,9,6
Saint Mary's (CA)10,10,Jordan Hunter,FR,F,Saint Mary's (CA),WCC,25,68,8,16,8,16,0,0,6,18,7,14,21,4,2,4,6,21,22
Saint Mary's (CA)11,11,Franklin Porter,FR,G,Saint Mary's (CA),WCC,20,62,9,20,5,12,4,8,8,9,7,12,19,1,1,0,3,5,30
Saint Peter's1,1,Antwon Portley,FR,G,Saint Peter's,MAAC,30,1011,131,347,64,150,67,197,91,109,8,89,97,56,19,3,55,46,420
Saint Peter's2,2,Chazz Patterson,JR,G,Saint Peter's,MAAC,30,955,78,223,37,89,41,134,43,62,9,129,138,51,43,21,58,54,240
Saint Peter's3,3,Quadir Welton,JR,C,Saint Peter's,MAAC,30,949,133,279,133,279,0,0,106,187,94,151,245,52,24,33,67,87,372
Saint Peter's4,4,Trevis Wyche,JR,G,Saint Peter's,MAAC,29,930,134,262,108,201,26,61,67,90,14,75,89,130,33,2,63,62,361
Saint Peter's5,5,Rodney Hawkins,SO,F,Saint Peter's,MAAC,30,559,68,155,61,131,7,24,18,32,52,88,140,24,10,13,44,72,161
Saint Peter's6,6,Cameron Jones,FR,G,Saint Peter's,MAAC,30,527,48,146,8,16,40,130,5,8,14,45,59,9,15,4,14,54,141
Saint Peter's7,7,Elias Desport,SR,F,Saint Peter's,MAAC,30,502,38,97,38,97,0,0,34,54,45,51,96,12,10,3,35,73,110
Saint Peter's8,8,Elisha Boone,SO,G,Saint Peter's,MAAC,30,413,47,90,47,86,0,4,15,32,34,83,117,20,8,13,30,47,109
Saint Peter's9,9,Samuel Idowu,FR,F,Saint Peter's,MAAC,24,131,18,42,16,35,2,7,2,3,12,17,29,3,2,3,8,23,40
Saint Peter's10,10,Mamadou Ndaiye,FR,F,Saint Peter's,MAAC,11,64,5,19,5,16,0,3,2,5,6,8,14,0,0,1,5,10,12
Sam Houston State1,1,Jamal Williams,SO,G,Sam Houston State,Southland,34,1020,124,253,112,219,12,34,68,95,51,135,186,148,38,5,79,69,328
Sam Houston State2,2,Dakarai Henderson,JR,G,Sam Houston State,Southland,32,953,150,396,75,177,75,219,78,113,26,65,91,47,19,2,42,48,453
Sam Houston State3,3,Jovante' Spivey,JR,G,Sam Houston State,Southland,34,837,77,218,48,119,29,99,97,138,22,59,81,85,25,2,47,71,280
Sam Houston State4,4,Aurimas Majauskas,JR,F,Sam Houston State,Southland,34,811,160,290,141,231,19,59,151,190,62,128,190,54,8,15,51,123,490
Sam Houston State5,5,Albert Almanza,SO,F,Sam Houston State,Southland,34,740,75,185,24,54,51,131,23,28,30,108,138,34,13,5,20,87,224
Sam Houston State6,6,Torry Butler,JR,F,Sam Houston State,Southland,34,679,83,180,74,145,9,35,37,65,58,142,200,47,28,10,35,96,212
Sam Houston State7,7,Jalin Barnes,FR,G,Sam Houston State,Southland,34,642,55,149,35,88,20,61,16,25,7,80,87,61,27,5,49,77,146
Sam Houston State8,8,Josh Delaney,SO,G,Sam Houston State,Southland,31,467,52,140,16,39,36,101,15,23,7,40,47,67,16,1,27,44,155
Sam Houston State9,9,Andre Sands,JR,C,Sam Houston State,Southland,32,271,51,83,51,81,0,2,17,32,31,32,63,8,5,2,20,65,119
Sam Houston State10,10,Marc Andre Fortin,FR,C,Sam Houston State,Southland,28,185,20,47,20,47,0,0,9,18,26,16,42,11,4,6,14,39,49
Sam Houston State11,11,Ameer Jackson,SO,G,Sam Houston State,Southland,4,99,12,37,6,20,6,17,14,25,3,5,8,6,0,1,6,9,44
Sam Houston State12,12,Jesse Lopez,SO,F,Sam Houston State,Southland,21,98,9,17,7,13,2,4,9,12,12,12,24,2,2,3,2,12,29
Sam Houston State13,13,Cam Delaney,SO,G,Sam Houston State,Southland,2,30,5,8,3,4,2,4,1,2,0,3,3,4,1,0,2,2,13
Sam Houston State14,14,Mitch McCormick,SR,G,Sam Houston State,Southland,9,19,3,10,0,1,3,9,0,1,0,1,1,1,2,0,0,0,9
Samford1,1,Christen Cunningham,SO,G,Samford,Southern,33,1114,161,357,142,287,19,70,135,163,17,76,93,128,34,2,87,54,476
Samford2,2,Darius Jones-Gibson,SR,G,Samford,Southern,33,1078,157,327,141,281,16,46,163,230,15,79,94,114,32,7,101,82,493
Samford3,3,Matt Rose,FR,F,Samford,Southern,33,831,98,240,35,86,63,154,37,57,36,102,138,23,24,5,36,59,296
Samford4,4,Marcus Johnson,SR,G,Samford,Southern,33,787,86,225,49,98,37,127,38,55,20,55,75,67,34,1,47,57,247
Samford5,5,Jamal Shabazz,SR,F,Samford,Southern,33,758,76,192,42,84,34,108,60,73,37,77,114,18,17,16,32,91,246
Samford6,6,Wyatt Walker,FR,C,Samford,Southern,32,705,133,229,133,225,0,4,74,105,64,128,192,25,20,26,52,87,340
Samford7,7,Iman Johnson,SR,F,Samford,Southern,33,688,60,127,53,97,7,30,29,47,45,105,150,40,43,13,42,87,156
Samford8,8,Alex Peters,SO,F,Samford,Southern,28,329,23,55,23,55,0,0,13,25,27,31,58,5,8,8,21,77,59
Samford9,9,Dakota Quinn,FR,F,Samford,Southern,27,204,32,58,32,56,0,2,7,15,11,38,49,3,6,15,13,41,71
Samford10,10,Eric Adams,SO,F,Samford,Southern,28,187,15,33,15,32,0,1,17,28,18,32,50,8,7,20,14,50,47
Samford11,11,Tanner Tapp,FR,G,Samford,Southern,6,9,3,6,2,3,1,3,0,0,0,1,1,2,0,0,1,1,7
Samford12,12,Ryan Dickey,JR,G,Samford,Southern,2,4,1,4,1,3,0,1,0,0,0,0,0,0,0,0,0,0,2
San Diego1,1,Vasa Pusica,SO,G,San Diego,WCC,30,789,86,195,61,130,25,65,52,69,17,102,119,74,21,4,59,60,249
San Diego2,2,Olin Carter III,FR,G,San Diego,WCC,30,764,74,221,30,80,44,141,28,41,10,72,82,46,17,6,41,73,220
San Diego3,3,Duda Sanadze,SR,G,San Diego,WCC,29,735,133,348,88,192,45,156,61,83,23,92,115,32,25,5,51,66,372
San Diego4,4,Brett Bailey,JR,F,San Diego,WCC,30,723,80,214,67,142,13,72,35,56,48,95,143,38,15,11,35,63,208
San Diego5,5,Jito Kok,SR,C,San Diego,WCC,30,704,79,150,79,150,0,0,62,93,60,77,137,27,3,76,65,84,220
San Diego6,6,Marcus Harris,SO,G,San Diego,WCC,26,662,53,160,26,55,27,105,39,52,6,54,60,19,21,2,27,66,172
San Diego7,7,Tyler Williams,FR,G,San Diego,WCC,30,537,23,78,15,44,8,34,20,36,14,55,69,45,18,3,35,57,74
San Diego8,8,Cameron Neubauer,SO,F,San Diego,WCC,21,316,33,77,13,27,20,50,17,24,8,33,41,15,4,1,13,51,103
San Diego9,9,Alex Floresca,FR,F,San Diego,WCC,28,310,23,41,23,41,0,0,25,36,20,31,51,13,2,2,23,49,71
San Diego10,10,Brandon Perry,JR,F,San Diego,WCC,13,177,25,47,25,47,0,0,24,51,22,25,47,7,3,6,21,37,74
San Diego11,11,Christian Oshita,FR,F,San Diego,WCC,18,152,10,34,5,15,5,19,4,9,9,20,29,4,2,0,12,17,29
San Diego12,12,Hunter Summy,FR,G,San Diego,WCC,14,72,8,32,3,6,5,26,1,3,2,0,2,5,2,0,3,9,22
San Diego13,13,Khalil Bedart-Ghani,SO,G,San Diego,WCC,15,59,3,17,3,12,0,5,2,6,8,12,20,3,6,2,7,8,8
San Diego State1,1,Trey Kell,SO,G,San Diego State,MWC,34,983,140,351,78,184,62,167,86,130,27,109,136,53,29,7,59,44,428
San Diego State2,2,Jeremy Hemsley,FR,G,San Diego State,MWC,33,933,135,306,95,199,40,107,99,129,18,67,85,62,25,10,70,73,409
San Diego State3,3,Winston Shepard,SR,F,San Diego State,MWC,33,931,117,305,107,265,10,40,124,178,56,154,210,92,30,13,66,57,368
San Diego State4,4,Skylar Spencer,SR,F,San Diego State,MWC,34,830,52,90,52,90,0,0,25,47,89,107,196,18,14,60,21,86,129
San Diego State5,5,Dakarai Allen,JR,G,San Diego State,MWC,34,751,67,173,42,80,25,93,50,78,15,75,90,39,35,18,39,74,209
San Diego State6,6,Zylan Cheatham,FR,F,San Diego State,MWC,34,731,83,159,80,142,3,17,105,148,53,132,185,33,21,24,62,80,274
San Diego State7,7,Malik Pope,SO,F,San Diego State,MWC,34,698,87,215,54,126,33,89,33,49,27,127,154,27,7,25,38,51,240
San Diego State8,8,Angelo Chol,SR,F,San Diego State,MWC,34,459,52,108,52,108,0,0,27,38,47,61,108,11,15,21,33,78,131
San Diego State9,9,Ben Perez,FR,G,San Diego State,MWC,24,243,26,78,10,19,16,59,3,4,6,14,20,5,8,5,11,17,71
San Diego State10,10,Matt Shrigley,JR,F,San Diego State,MWC,14,151,8,38,1,3,7,35,0,0,3,11,14,9,1,1,6,13,23
San Diego State11,11,D'Erryl Williams,JR,G,San Diego State,MWC,18,121,8,19,8,16,0,3,8,14,1,12,13,6,6,0,9,15,24
San Diego State12,12,Parker U'u,JR,G,San Diego State,MWC,7,11,1,4,1,1,0,3,2,2,0,4,4,4,0,0,0,1,4
San Diego State13,13,Niksha Federico,JR,F,San Diego State,MWC,5,8,2,6,1,2,1,4,0,0,0,1,1,1,1,0,0,1,5
San Francisco1,1,Devin Watson,SO,G,San Francisco,WCC,30,1041,192,459,127,273,65,186,159,217,9,65,74,146,27,0,89,53,608
San Francisco2,2,Tim Derksen,SR,G,San Francisco,WCC,30,978,177,358,127,245,50,113,103,141,74,134,208,60,21,9,47,79,507
San Francisco3,3,Uche Ofoegbu,JR,F,San Francisco,WCC,30,775,101,199,71,130,30,69,43,67,30,107,137,25,18,10,51,71,275
San Francisco4,4,Dont'e Reynolds,JR,F,San Francisco,WCC,30,705,53,101,53,98,0,3,46,72,73,128,201,23,21,25,45,97,152
San Francisco5,5,Ronnie Boyce III,JR,G,San Francisco,WCC,28,582,113,287,75,170,38,117,46,63,20,75,95,42,25,11,34,54,310
San Francisco6,6,Chase Foster,SO,F,San Francisco,WCC,30,526,45,117,18,41,27,76,16,24,10,43,53,25,9,1,17,53,133
San Francisco7,7,Nate Renfro,FR,F,San Francisco,WCC,29,427,43,85,38,66,5,19,20,46,33,49,82,12,14,19,28,75,111
San Francisco8,8,Matthew McCarthy,FR,F,San Francisco,WCC,30,407,31,84,31,72,0,12,9,24,44,67,111,12,10,5,20,49,71
San Francisco9,9,Montray Clemons,SR,F,San Francisco,WCC,23,233,25,63,25,59,0,4,17,24,22,40,62,4,6,4,17,37,67
San Francisco10,10,Sean Grennan,SR,G,San Francisco,WCC,23,169,11,29,3,5,8,24,7,10,0,11,11,15,4,2,5,20,37
San Francisco11,11,Mladen Djordjevic,FR,G,San Francisco,WCC,21,157,8,25,1,8,7,17,4,7,0,11,11,5,4,1,10,24,27
San Francisco12,12,Marquill Smith,FR,G,San Francisco,WCC,10,70,8,27,5,10,3,17,4,6,3,9,12,2,3,0,2,3,23
San Francisco13,13,Randy Cruzet,SO,G,San Francisco,WCC,3,5,1,2,1,2,0,0,0,0,0,0,0,0,0,0,1,2,2
San Jose State1,1,Frank Rogers,JR,F,San Jose State,MWC,31,892,134,292,97,184,37,108,65,95,65,155,220,47,23,22,57,94,370
San Jose State2,2,Ryan Welage,FR,F,San Jose State,MWC,31,817,122,301,74,168,48,133,29,55,29,133,162,39,21,3,45,71,321
San Jose State3,3,Princeton Onwas,SR,G,San Jose State,MWC,31,792,110,242,97,179,13,63,91,149,24,71,95,73,24,6,80,97,324
San Jose State4,4,Cody Schwartz,FR,F,San Jose State,MWC,31,746,72,195,20,42,52,153,22,30,21,62,83,32,15,7,21,77,218
San Jose State5,5,Brandon Clarke,FR,G,San Jose State,MWC,31,728,104,163,103,157,1,6,55,98,65,109,174,46,22,38,34,54,264
San Jose State6,6,Isaac Thornton,JR,G,San Jose State,MWC,31,602,51,125,39,87,12,38,49,72,14,69,83,78,43,15,50,79,163
San Jose State7,7,Jaycee Hillsman,FR,G,San Jose State,MWC,30,529,39,126,19,50,20,76,38,49,14,23,37,44,9,5,35,68,136
San Jose State8,8,Gary Williams Jr.,JR,G,San Jose State,MWC,30,454,62,177,48,116,14,61,65,77,16,54,70,40,14,3,41,51,203
San Jose State9,9,Jalen James,JR,G,San Jose State,MWC,23,386,38,105,27,61,11,44,29,42,4,40,44,36,10,5,37,45,116
San Jose State10,10,Leon Bahner,SO,C,San Jose State,MWC,26,201,14,37,14,37,0,0,14,22,20,40,60,8,2,16,15,38,42
San Jose State11,11,Ivo Basor,SR,C,San Jose State,MWC,15,60,9,14,5,9,4,5,5,12,4,8,12,2,0,0,3,11,27
San Jose State12,12,Danny Mahoney,SO,G,San Jose State,MWC,3,18,1,6,1,3,0,3,0,0,0,3,3,4,2,0,1,2,2
Santa Clara1,1,Jared Brownridge,JR,G,Santa Clara,WCC,31,1110,195,491,104,255,91,236,159,191,11,87,98,72,22,6,58,67,640
Santa Clara2,2,KJ Feagin,FR,G,Santa Clara,WCC,31,958,127,289,89,182,38,107,60,75,6,72,78,117,18,3,71,63,352
Santa Clara3,3,Nate Kratch,JR,F,Santa Clara,WCC,31,860,110,203,110,203,0,0,53,91,88,156,244,19,20,23,33,92,273
Santa Clara4,4,Kai Healy,SO,G,Santa Clara,WCC,31,643,63,157,38,87,25,70,37,44,9,91,100,32,14,8,35,58,188
Santa Clara5,5,Matt Hauser,FR,G,Santa Clara,WCC,31,600,51,146,25,73,26,73,27,36,8,37,45,40,15,0,27,35,155
Santa Clara6,6,Matt Hubbard,SO,F,Santa Clara,WCC,29,587,62,169,41,85,21,84,22,27,18,55,73,25,9,11,31,61,167
Santa Clara7,7,Emmanuel Ndumanya,SO,C,Santa Clara,WCC,31,407,16,38,15,37,1,1,14,34,50,71,121,4,5,13,23,71,47
Santa Clara8,8,Henrik Jadersten,FR,F,Santa Clara,WCC,31,377,40,114,17,42,23,72,10,14,17,52,69,13,5,13,15,61,113
Santa Clara9,9,Brendyn Taylor,JR,G,Santa Clara,WCC,24,350,27,67,20,44,7,23,22,45,8,42,50,27,10,2,20,49,83
Santa Clara10,10,Jarvis Pugh,SO,G,Santa Clara,WCC,10,215,18,41,18,40,0,1,8,17,13,35,48,9,8,2,12,37,44
Santa Clara11,11,Evan Wardlow,SO,F,Santa Clara,WCC,7,139,4,17,4,14,0,3,5,8,6,10,16,17,6,2,8,12,13
Savannah State1,1,Troyce Manassa,JR,G,Savannah State,MEAC,31,924,127,305,105,235,22,70,115,143,21,137,158,73,32,15,72,72,391
Savannah State2,2,Chris Martin,SR,G,Savannah State,MEAC,31,852,118,314,49,109,69,205,70,91,4,81,85,57,20,2,47,57,375
Savannah State3,3,Lenjo Kilo,SR,F,Savannah State,MEAC,31,804,117,248,109,221,8,27,62,120,73,100,173,14,16,23,63,94,304
Savannah State4,4,Brian Pearson,SR,F,Savannah State,MEAC,31,729,53,120,53,118,0,2,34,63,55,108,163,23,12,15,43,87,140
Savannah State5,5,Khalen Pinkett,SO,G,Savannah State,MEAC,31,607,41,117,38,102,3,15,39,68,11,44,55,49,32,2,72,67,124
Savannah State6,6,Dexter McClanahan,FR,G,Savannah State,MEAC,31,459,39,95,30,57,9,38,37,57,12,26,38,29,19,5,25,48,124
Savannah State7,7,Javaris Jenkins,JR,F,Savannah State,MEAC,20,377,33,85,16,44,17,41,21,28,9,52,61,19,11,3,16,38,104
Savannah State8,8,Isaiah Felder,FR,G,Savannah State,MEAC,31,331,26,75,10,24,16,51,7,9,4,23,27,25,13,0,35,26,75
Savannah State9,9,Teslim Idris,JR,F,Savannah State,MEAC,28,330,25,52,20,40,5,12,7,16,17,24,41,10,10,7,14,40,62
Savannah State10,10,Kamil Williams,FR,G,Savannah State,MEAC,27,295,38,115,7,19,31,96,24,38,4,28,32,11,9,1,17,40,131
Savannah State11,11,Casey Wells,JR,G,Savannah State,MEAC,22,268,20,76,4,11,16,65,5,7,4,9,13,10,11,1,19,15,61
Savannah State12,12,Brandon Jordan,JR,F,Savannah State,MEAC,16,139,7,13,7,13,0,0,6,11,9,16,25,2,1,5,7,23,20
Savannah State13,13,Novian Cherry,JR,G,Savannah State,MEAC,12,95,7,20,7,19,0,1,4,8,6,5,11,1,2,1,10,9,18
Savannah State14,14,Jason Baxter,FR,C,Savannah State,MEAC,7,15,1,1,1,1,0,0,0,0,0,2,2,0,0,1,2,3,2
Seattle1,1,Brendan Westendorf,JR,G,Seattle,WAC,30,962,131,329,82,208,49,121,63,84,34,118,152,127,55,4,96,63,374
Seattle2,2,Jack Crook,SR,C,Seattle,WAC,30,884,121,250,121,249,0,1,57,97,56,122,178,58,15,19,80,98,299
Seattle3,3,William Powell,JR,F,Seattle,WAC,30,874,90,184,90,183,0,1,87,145,71,136,207,76,28,2,86,87,267
Seattle4,4,Manroop Clair,JR,G,Seattle,WAC,29,655,82,215,13,34,69,181,24,28,3,43,46,16,12,0,27,35,257
Seattle5,5,Jadon Cohee,SO,G,Seattle,WAC,29,595,73,188,49,126,24,62,52,62,6,49,55,30,12,0,41,37,222
Seattle6,6,Emmanuel Chibuogwu,JR,G,Seattle,WAC,29,591,53,120,52,111,1,9,33,43,23,70,93,28,13,6,34,54,140
Seattle7,7,Aaron Menzies,FR,C,Seattle,WAC,30,501,59,111,59,111,0,0,19,42,49,99,148,10,8,15,45,75,137
Seattle8,8,Jake Spurgeon,FR,G,Seattle,WAC,21,308,27,85,11,20,16,65,7,14,9,19,28,10,7,1,10,34,77
Seattle9,9,Jack Shaughnessy,FR,G,Seattle,WAC,27,294,19,64,14,36,5,28,22,34,8,29,37,11,12,0,15,28,65
Seattle10,10,Malik Montoya,FR,G,Seattle,WAC,13,263,27,57,18,37,9,20,7,12,6,22,28,23,19,0,14,13,70
Seattle11,11,Zack Moore,FR,F,Seattle,WAC,14,98,14,29,5,7,9,22,7,7,7,10,17,4,1,1,6,18,44
Seton Hall1,1,Isaiah Whitehead,SO,G,Seton Hall,Big East,33,1062,190,488,109,276,81,212,147,192,18,100,118,165,38,48,117,76,608
Seton Hall2,2,Khadeen Carrington,SO,G,Seton Hall,Big East,33,1018,160,382,106,220,54,162,97,129,14,90,104,84,36,4,67,59,471
Seton Hall3,3,Angel Delgado,SO,F,Seton Hall,Big East,33,996,137,240,137,238,0,2,57,104,98,213,311,33,18,28,61,89,331
Seton Hall4,4,Ismael Sanogo,SO,G,Seton Hall,Big East,32,900,59,119,59,118,0,1,42,73,88,141,229,44,46,35,38,102,160
Seton Hall5,5,Desi Rodriguez,SO,F,Seton Hall,Big East,33,859,148,292,117,211,31,81,86,123,51,119,170,47,53,7,56,63,413
Seton Hall6,6,Derrick Gordon,SR,G,Seton Hall,Big East,33,779,94,232,80,181,14,51,60,101,36,71,107,56,33,8,62,66,262
Seton Hall7,7,Michael Nzei,SO,F,Seton Hall,Big East,33,442,48,76,48,76,0,0,17,34,50,46,96,6,5,19,22,58,113
Seton Hall8,8,Veer Singh,FR,F,Seton Hall,Big East,29,262,21,70,4,15,17,55,6,10,8,28,36,4,3,0,12,41,65
Seton Hall9,9,Rashed Anthony,SO,F,Seton Hall,Big East,27,129,5,11,5,11,0,0,3,4,2,18,20,5,4,3,5,35,13
Seton Hall10,10,Braeden Anderson,SR,F,Seton Hall,Big East,18,109,3,12,3,12,0,0,8,12,9,17,26,1,3,1,4,20,14
Seton Hall11,11,Myles Carter,FR,F,Seton Hall,Big East,9,32,2,2,2,2,0,0,1,4,3,3,6,1,0,1,3,5,5
Seton Hall12,12,Dalton Soffer,FR,G,Seton Hall,Big East,13,24,4,8,0,0,4,8,0,0,0,3,3,1,1,0,0,2,12
Seton Hall13,13,MIchael Dowdy,JR,G,Seton Hall,Big East,10,13,1,5,0,4,1,1,0,1,1,3,4,0,0,0,0,0,3
Siena1,1,Brett Bisping,JR,F,Siena,MAAC,33,1090,176,380,137,271,39,109,137,172,79,269,348,47,23,14,77,103,528
Siena2,2,Javion Ogunyemi,JR,F,Siena,MAAC,33,1038,178,328,171,305,7,23,134,199,112,92,204,32,14,70,65,102,497
Siena3,3,Lavon Long,JR,F,Siena,MAAC,32,957,109,223,105,202,4,21,119,156,62,115,177,106,31,20,102,100,341
Siena4,4,Nico Clareth,FR,G,Siena,MAAC,33,873,169,366,117,201,52,165,43,70,32,73,105,73,52,19,74,85,433
Siena5,5,Ryan Oliver,SR,G,Siena,MAAC,33,798,82,208,35,88,47,120,19,33,20,77,97,44,14,0,37,66,230
Siena6,6,Kenny Wormley,FR,G,Siena,MAAC,33,694,49,122,37,93,12,29,43,64,20,69,89,62,19,3,48,70,153
Siena7,7,Marquis Wright,JR,G,Siena,MAAC,18,636,90,215,65,157,25,58,55,67,21,61,82,88,35,7,62,52,260
Siena8,8,Evan Fisher,FR,F,Siena,MAAC,33,273,21,43,13,29,8,14,4,6,13,29,42,6,2,3,7,61,54
Siena9,9,Kinnon LaRose,FR,G,Siena,MAAC,29,156,12,24,3,4,9,20,4,4,12,15,27,10,6,3,10,17,37
Siena10,10,Imoh Silas,SR,C,Siena,MAAC,20,98,6,15,6,15,0,0,1,3,6,14,20,3,3,11,12,26,13
Siena11,11,Cameron Gottfried,SO,G,Siena,MAAC,22,63,6,7,4,4,2,3,3,4,2,12,14,3,1,0,7,8,17
Siena12,12,Nick Cunningham,FR,G,Siena,MAAC,10,15,1,2,1,2,0,0,10,12,1,0,1,2,1,0,2,2,12
Siena13,13,Jimmy Merrill,JR,F,Siena,MAAC,9,12,1,2,0,0,1,2,0,0,0,1,1,0,1,0,0,1,3
South Alabama1,1,Ken Williams,JR,G,South Alabama,Sun Belt,31,963,153,418,92,223,61,195,112,140,18,86,104,106,26,6,82,36,479
South Alabama2,2,Nick Stover,JR,F,South Alabama,Sun Belt,33,945,115,280,83,183,32,97,72,105,30,86,116,56,25,15,77,72,334
South Alabama3,3,Barrington Stevens,SR,G,South Alabama,Sun Belt,33,932,60,170,33,96,27,74,40,53,14,74,88,82,22,1,64,64,187
South Alabama4,4,Georgi Boyanov,JR,F,South Alabama,Sun Belt,33,837,112,222,93,165,19,57,101,139,87,156,243,14,25,14,43,76,344
South Alabama5,5,Shaq Calhoun,SO,G,South Alabama,Sun Belt,33,631,95,235,46,97,49,138,49,66,17,60,77,16,43,7,52,76,288
South Alabama6,6,Tafari Whittingham,JR,F,South Alabama,Sun Belt,30,552,55,133,53,125,2,8,33,86,37,72,109,6,13,22,38,78,145
South Alabama7,7,John Brown,SR,G,South Alabama,Sun Belt,32,519,62,147,46,96,16,51,22,28,21,45,66,28,19,13,28,33,162
South Alabama8,8,Don MuepoKelly,JR,F,South Alabama,Sun Belt,32,509,62,142,61,138,1,4,25,47,48,76,124,14,30,28,33,72,150
South Alabama9,9,Nikola Marijan,FR,F,South Alabama,Sun Belt,32,392,28,67,28,67,0,0,17,34,33,47,80,8,9,16,36,95,73
South Alabama10,10,Nick Davis,SO,G,South Alabama,Sun Belt,25,327,24,58,18,34,6,24,11,21,22,69,91,8,8,10,15,50,65
South Alabama11,11,Taishaun Johnson,SO,G,South Alabama,Sun Belt,5,93,17,44,17,32,0,12,17,23,6,10,16,10,1,0,9,7,51
South Alabama12,12,Devin Epps,SO,G,South Alabama,Sun Belt,11,25,1,1,1,1,0,0,4,5,0,1,1,2,0,0,2,5,6
South Carolina1,1,Sindarius Thornwell,JR,G,South Carolina,SEC,32,1059,133,354,91,225,42,129,121,158,39,120,159,121,47,14,76,60,429
South Carolina2,2,Mindaugas Kacinas,SR,F,South Carolina,SEC,32,937,120,237,100,175,20,62,61,94,67,103,170,27,15,14,32,68,321
South Carolina3,3,Duane Notice,JR,G,South Carolina,SEC,32,872,112,284,47,123,65,161,65,87,24,51,75,68,31,1,34,53,354
South Carolina4,4,Michael Carrera,SR,F,South Carolina,SEC,30,836,135,300,86,183,49,117,115,153,65,165,230,39,30,29,58,83,434
South Carolina5,5,Laimonas Chatkevicius,SR,F,South Carolina,SEC,32,706,121,236,114,210,7,26,58,79,68,84,152,23,17,29,57,79,307
South Carolina6,6,PJ Dozier,FR,G,South Carolina,SEC,32,602,83,222,75,180,8,42,36,65,26,70,96,64,33,12,84,82,210
South Carolina7,7,Marcus Stroman,SO,G,South Carolina,SEC,29,426,14,54,9,45,5,9,35,53,17,40,57,38,18,4,31,44,68
South Carolina8,8,Chris Silva,FR,F,South Carolina,SEC,32,425,53,110,53,110,0,0,67,110,56,87,143,6,14,28,34,100,173
South Carolina9,9,Justin McKie,JR,G,South Carolina,SEC,24,182,11,41,9,26,2,15,7,12,7,13,20,19,2,2,5,15,31
South Carolina10,10,Eric Cobb,FR,F,South Carolina,SEC,24,147,13,23,13,23,0,0,1,18,13,32,45,3,1,3,14,26,27
South Carolina11,11,Jamall Gregory,FR,G,South Carolina,SEC,20,133,12,24,10,18,2,6,8,13,4,15,19,12,6,2,7,23,34
South Carolina12,12,Raymond Doby,FR,F,South Carolina,SEC,14,77,9,24,9,23,0,1,9,15,8,7,15,2,4,1,4,8,27
South Carolina13,13,TeMarcus Blanton,FR,G,South Carolina,SEC,8,32,3,8,1,4,2,4,4,4,2,3,5,2,2,0,1,4,12
South Carolina14,14,John Ragin,FR,G,South Carolina,SEC,4,8,1,3,1,2,0,1,0,0,0,1,1,0,1,0,0,0,2
South Carolina State1,1,Edward Stephens,SO,G,South Carolina State,MEAC,34,1033,149,341,59,118,90,223,58,69,12,70,82,56,24,1,33,60,446
South Carolina State2,2,Eric Eaves,JR,G,South Carolina State,MEAC,34,961,196,376,170,304,26,72,180,236,26,69,95,66,27,8,79,69,598
South Carolina State3,3,Gabe McCray,SR,G,South Carolina State,MEAC,34,855,150,307,129,252,21,55,75,120,56,109,165,33,23,1,51,92,396
South Carolina State4,4,Darryl Palmer,SR,C,South Carolina State,MEAC,34,841,99,202,98,189,1,13,51,85,48,149,197,32,17,49,22,91,250
South Carolina State5,5,Greg Mortimer,JR,G,South Carolina State,MEAC,34,813,84,223,59,146,25,77,69,85,19,74,93,81,23,3,67,60,262
South Carolina State6,6,Tashombe Riley,SO,F,South Carolina State,MEAC,34,729,120,263,118,249,2,14,32,40,60,115,175,15,11,8,25,82,274
South Carolina State7,7,Ty Solomon,SO,G,South Carolina State,MEAC,33,693,32,103,12,32,20,71,23,28,10,60,70,121,23,3,61,73,107
South Carolina State8,8,DouDou Gueye,JR,C,South Carolina State,MEAC,34,291,13,25,13,25,0,0,2,8,18,37,55,6,4,9,15,49,28
South Carolina State9,9,Luka Radovic,SR,F,South Carolina State,MEAC,34,287,19,40,15,29,4,11,12,17,20,38,58,8,2,8,24,61,54
South Carolina State10,10,Najee Pritchett,JR,G,South Carolina State,MEAC,32,259,22,68,10,17,12,51,10,26,13,19,32,10,2,4,4,18,66
South Carolina State11,11,Jaylen Reid,JR,F,South Carolina State,MEAC,5,23,1,5,1,4,0,1,0,0,2,1,3,2,0,0,0,0,2
South Carolina Upstate1,1,Mike Cunningham,FR,G,South Carolina Upstate,A-Sun,32,926,99,269,45,113,54,156,61,80,6,77,83,85,25,0,57,55,313
South Carolina Upstate2,2,Josh Cuthbertson,JR,F,South Carolina Upstate,A-Sun,31,840,103,234,64,110,39,124,50,70,30,109,139,84,18,2,52,58,295
South Carolina Upstate3,3,Deion Holmes,FR,G,South Carolina Upstate,A-Sun,32,802,137,378,83,210,54,168,64,80,32,50,82,45,19,5,67,72,392
South Carolina Upstate4,4,Jure Span,FR,G,South Carolina Upstate,A-Sun,32,715,52,123,22,55,30,68,17,29,14,47,61,100,19,11,45,89,151
South Carolina Upstate5,5,Michael Buchanan,JR,C,South Carolina Upstate,A-Sun,31,672,153,269,153,269,0,0,53,92,74,113,187,42,17,31,62,88,359
South Carolina Upstate6,6,Marvin Smith,SR,F,South Carolina Upstate,A-Sun,31,648,69,132,68,129,1,3,36,55,45,99,144,24,11,7,46,65,175
South Carolina Upstate7,7,Jacob Schulte,SO,F,South Carolina Upstate,A-Sun,32,574,70,116,70,116,0,0,33,70,53,38,91,22,17,15,27,58,173
South Carolina Upstate8,8,Malik Moore,FR,F,South Carolina Upstate,A-Sun,32,509,63,133,43,76,20,57,27,54,40,88,128,36,23,11,29,56,173
South Carolina Upstate9,9,Philip Whittington,FR,F,South Carolina Upstate,A-Sun,28,368,77,154,77,153,0,1,20,30,30,94,124,14,9,19,32,44,174
South Carolina Upstate10,10,Tristan Thomas,JR,G,South Carolina Upstate,A-Sun,20,205,16,48,1,6,15,42,1,3,1,12,13,21,12,0,9,18,48
South Carolina Upstate11,11,Ramel Thompkins,SO,F,South Carolina Upstate,A-Sun,13,118,12,28,8,15,4,13,4,6,3,14,17,7,5,4,4,7,32
South Carolina Upstate12,12,Damian Goodwin,JR,F,South Carolina Upstate,A-Sun,3,59,8,28,8,22,0,6,10,19,4,10,14,2,0,1,7,13,26
South Carolina Upstate13,13,Blake Edwards,FR,G,South Carolina Upstate,A-Sun,6,5,1,2,0,0,1,2,1,2,0,2,2,1,0,0,2,0,4
South Dakota1,1,Casey Kasperbauer,SR,G,South Dakota,Summit,32,1065,124,302,53,129,71,173,69,73,6,74,80,67,32,0,31,35,388
South Dakota2,2,Trey Norris,SR,G,South Dakota,Summit,32,949,87,190,68,139,19,51,48,60,18,55,73,139,38,3,68,82,241
South Dakota3,3,D.J. Davis,SO,G,South Dakota,Summit,32,944,114,207,96,159,18,48,47,61,26,88,114,83,41,10,66,86,293
South Dakota4,4,Tre Burnette,SR,G,South Dakota,Summit,32,752,172,389,131,260,41,129,38,74,47,164,211,48,25,32,51,90,423
South Dakota5,5,Shy McClelland,JR,G,South Dakota,Summit,23,663,100,203,88,171,12,32,52,102,17,75,92,82,34,3,42,81,264
South Dakota6,6,Eric Robertson,SR,F,South Dakota,Summit,32,656,104,221,102,217,2,4,54,67,35,67,102,10,13,18,25,76,264
South Dakota7,7,Dan Jech,FR,F,South Dakota,Summit,31,400,81,156,69,118,12,38,36,58,20,56,76,6,3,12,33,64,210
South Dakota8,8,Tyler Hagedorn,FR,F,South Dakota,Summit,31,368,30,97,13,37,17,60,16,23,12,52,64,29,10,11,23,61,93
South Dakota9,9,Tyler Flack,JR,F,South Dakota,Summit,17,294,63,108,61,100,2,8,41,48,36,58,94,9,11,19,22,41,169
South Dakota10,10,Austin Sparks,SO,F,South Dakota,Summit,20,165,14,24,14,24,0,0,8,14,13,19,32,2,0,3,8,21,36
South Dakota11,11,Duol Mayot,SR,F,South Dakota,Summit,17,102,9,20,9,20,0,0,3,7,10,14,24,6,2,0,8,12,21
South Dakota12,12,Logan Power,FR,F,South Dakota,Summit,14,87,11,26,5,9,6,17,6,9,1,11,12,3,0,1,3,5,34
South Dakota13,13,Zach Dickerson,SO,G,South Dakota,Summit,17,80,3,11,2,6,1,5,0,0,2,4,6,8,0,1,2,8,7
South Dakota State1,1,Deondre Parks,SR,G,South Dakota State,Summit,32,1035,157,379,109,232,48,147,108,134,25,124,149,48,26,7,54,74,470
South Dakota State2,2,Reed Tellinghuisen,SO,G,South Dakota State,Summit,33,985,100,252,42,94,58,158,41,67,46,117,163,40,10,14,53,82,299
South Dakota State3,3,George Marshall,SR,G,South Dakota State,Summit,27,920,132,329,71,165,61,164,76,100,2,92,94,74,22,2,35,54,401
South Dakota State4,4,Keaton Moffitt,SR,G,South Dakota State,Summit,32,754,73,141,69,130,4,11,34,56,40,101,141,64,24,5,38,72,184
South Dakota State5,5,Mike Daum,FR,F,South Dakota State,Summit,33,677,167,298,140,238,27,60,141,172,71,130,201,27,16,11,53,68,502
South Dakota State6,6,Jake Bittle,SR,G,South Dakota State,Summit,25,644,72,172,51,107,21,65,49,61,35,84,119,55,26,3,51,67,214
South Dakota State7,7,Ian Theisen,SO,F,South Dakota State,Summit,33,576,70,132,56,102,14,30,50,63,39,78,117,17,6,21,34,97,204
South Dakota State8,8,Tevin King,FR,G,South Dakota State,Summit,33,469,39,94,35,80,4,14,41,69,18,40,58,26,26,2,32,62,123
South Dakota State9,9,Lane Severyn,SO,G,South Dakota State,Summit,27,273,17,42,9,13,8,29,6,8,15,37,52,14,4,3,15,38,48
South Dakota State10,10,Connor Devine,JR,F,South Dakota State,Summit,25,209,24,37,24,37,0,0,17,31,17,23,40,7,2,14,7,35,65
South Dakota State11,11,Logan Doyle,SO,F,South Dakota State,Summit,6,15,2,7,2,7,0,0,1,3,1,6,7,0,1,0,1,1,5
South Florida1,1,Jahmal McMurray,FR,G,South Florida,AAC,33,1161,184,471,111,260,73,211,59,74,11,80,91,81,13,4,81,61,500
South Florida2,2,Angel Nunez,SR,F,South Florida,AAC,33,958,118,302,95,205,23,97,56,84,41,159,200,33,24,22,71,62,315
South Florida3,3,Nehemias Morillo,SR,G,South Florida,AAC,33,906,98,281,64,166,34,115,57,74,14,59,73,68,25,9,68,64,287
South Florida4,4,Jaleel Cousins,SR,C,South Florida,AAC,33,825,95,210,95,209,0,1,90,155,101,161,262,15,23,54,68,105,280
South Florida5,5,Ruben Guerrero,SO,C,South Florida,AAC,32,761,71,118,71,118,0,0,23,36,71,109,180,11,12,41,27,73,165
South Florida6,6,Bo Zeigler,SO,F,South Florida,AAC,32,711,54,97,53,87,1,10,17,37,30,61,91,45,23,29,51,75,126
South Florida7,7,Chris Perry,JR,F,South Florida,AAC,27,651,105,230,105,225,0,5,62,93,61,116,177,31,11,13,48,72,272
South Florida8,8,Roddy Peters,SO,G,South Florida,AAC,10,266,37,90,35,76,2,14,22,35,6,27,33,35,10,1,39,26,98
South Florida9,9,Jake Bodway,SO,G,South Florida,AAC,26,236,9,34,9,24,0,10,7,9,11,8,19,11,6,0,12,30,25
South Florida10,10,Luis Santos,FR,F,South Florida,AAC,15,105,3,15,3,15,0,0,11,15,14,19,33,1,3,3,6,17,17
Southeast Missouri State1,1,Isiah Jones,SR,G,Southeast Missouri State,OVC,29,865,101,280,46,110,55,170,45,65,10,79,89,86,49,2,69,81,302
Southeast Missouri State2,2,Antonius Cleveland,JR,G,Southeast Missouri State,OVC,26,817,150,343,142,297,8,46,86,141,62,109,171,61,42,15,60,72,394
Southeast Missouri State3,3,Joel Angus III,JR,F,Southeast Missouri State,OVC,29,816,111,222,111,220,0,2,83,115,65,107,172,32,20,14,60,63,305
Southeast Missouri State4,4,Eric McGill,FR,G,Southeast Missouri State,OVC,27,741,70,189,40,97,30,92,18,41,11,53,64,50,38,0,37,42,188
Southeast Missouri State5,5,Trey Kellum,JR,F,Southeast Missouri State,OVC,25,596,99,201,99,201,0,0,61,105,52,90,142,14,12,4,52,92,259
Southeast Missouri State6,6,Jamaal Calvin,JR,G,Southeast Missouri State,OVC,21,559,40,130,13,40,27,90,32,39,15,54,69,49,18,1,29,39,139
Southeast Missouri State7,7,Tony Anderson II,FR,F,Southeast Missouri State,OVC,29,426,49,120,42,100,7,20,41,55,23,39,62,8,11,6,32,21,146
Southeast Missouri State8,8,Kyle Gullett,FR,F,Southeast Missouri State,OVC,23,285,14,45,5,22,9,23,3,5,15,19,34,14,7,1,9,22,40
Southeast Missouri State9,9,Jaylin Stewart,FR,F,Southeast Missouri State,OVC,26,210,18,52,11,25,7,27,3,8,7,38,45,2,5,2,7,33,46
Southeast Missouri State10,10,Marcus Wallace,SO,G,Southeast Missouri State,OVC,8,201,25,60,20,41,5,19,6,18,10,20,30,25,8,1,18,16,61
Southeast Missouri State11,11,Ladarius Coleman,SO,F,Southeast Missouri State,OVC,6,141,15,40,13,32,2,8,9,12,13,22,35,7,4,0,13,12,41
Southeast Missouri State12,12,Robby Dosier,FR,G,Southeast Missouri State,OVC,15,99,2,9,1,3,1,6,1,2,0,10,10,4,1,0,8,11,6
Southeast Missouri State13,13,J.T. Jones,SO,G,Southeast Missouri State,OVC,5,68,5,19,2,9,3,10,4,6,1,11,12,6,3,0,3,10,17
Southeastern Louisiana1,1,Zay Jackson,SR,G,Southeastern Louisiana,Southland,33,1062,143,352,96,216,47,136,79,106,25,115,140,158,42,5,119,83,412
Southeastern Louisiana2,2,Joshua Filmore,JR,G,Southeastern Louisiana,Southland,33,992,103,265,35,80,68,185,20,36,8,70,78,84,22,1,34,46,294
Southeastern Louisiana3,3,JaMichael Hawkins,SR,G,Southeastern Louisiana,Southland,33,787,94,233,22,55,72,178,31,37,5,47,52,36,24,2,44,48,291
Southeastern Louisiana4,4,Marlain Veal,FR,G,Southeastern Louisiana,Southland,33,716,79,176,60,123,19,53,65,92,23,54,77,98,40,3,82,80,242
Southeastern Louisiana5,5,Jordan Capps,JR,F,Southeastern Louisiana,Southland,32,661,128,244,121,226,7,18,56,121,66,134,200,12,8,26,50,77,319
Southeastern Louisiana6,6,Moses Greenwood,FR,F,Southeastern Louisiana,Southland,33,591,98,172,98,171,0,1,54,85,43,99,142,9,13,19,33,102,250
Southeastern Louisiana7,7,Dimi Cook,FR,G,Southeastern Louisiana,Southland,28,537,59,135,42,93,17,42,74,91,6,34,40,34,22,1,36,76,209
Southeastern Louisiana8,8,Dominic Nelson,JR,C,Southeastern Louisiana,Southland,30,456,26,59,26,59,0,0,27,62,42,77,119,2,7,19,33,69,79
Southeastern Louisiana9,9,James Currington,SO,F,Southeastern Louisiana,Southland,18,380,46,92,46,92,0,0,10,23,32,58,90,16,20,8,32,47,102
Southeastern Louisiana10,10,Keith Charleston,JR,G,Southeastern Louisiana,Southland,10,239,33,51,32,50,1,1,14,25,15,41,56,10,6,1,24,24,81
Southeastern Louisiana11,11,Daniel Grieves,SR,F,Southeastern Louisiana,Southland,13,186,21,51,12,20,9,31,11,16,8,16,24,12,5,4,8,33,62
Southeastern Louisiana12,12,Justin Lobell,SO,G,Southeastern Louisiana,Southland,3,1,1,1,0,0,1,1,0,0,0,0,0,0,0,0,1,0,3
Southern1,1,Christopher Hyder,SR,G,Southern,SWAC,34,1218,112,233,103,192,9,41,92,119,12,113,125,169,83,2,58,80,325
Southern2,2,Adrian Rodgers,SR,G,Southern,SWAC,34,1102,195,474,116,263,79,211,97,123,34,148,182,43,37,4,58,59,566
Southern3,3,Trelun Banks,JR,G,Southern,SWAC,32,1101,134,362,80,215,54,147,82,129,22,67,89,71,33,0,75,72,404
Southern4,4,Jared Sam,SO,F,Southern,SWAC,34,901,118,209,118,209,0,0,90,139,70,147,217,31,26,24,41,96,326
Southern5,5,Shawn Prudhomme,JR,F,Southern,SWAC,34,660,124,258,78,141,46,117,34,38,34,76,110,18,27,21,31,73,328
Southern6,6,Chris Thomas,SO,G,Southern,SWAC,34,571,53,147,52,130,1,17,45,74,35,85,120,13,18,10,35,76,152
Southern7,7,Tony Nunn,JR,F,Southern,SWAC,34,411,55,100,55,100,0,0,17,42,40,60,100,3,4,39,27,78,127
Southern8,8,Rashad Andrews,SO,G,Southern,SWAC,26,334,35,80,21,41,14,39,17,32,6,39,45,11,8,4,17,38,101
Southern9,9,D'Arian Allen,JR,F,Southern,SWAC,27,301,42,71,41,70,1,1,16,35,33,41,74,4,6,9,23,67,101
Southern10,10,LaQuentin Collins,SO,G,Southern,SWAC,20,147,14,44,11,29,3,15,7,11,5,13,18,9,10,4,11,18,38
Southern11,11,Thomas Pierre-Louis,SR,F,Southern,SWAC,10,46,3,8,3,8,0,0,0,1,3,2,5,0,2,4,1,1,6
Southern12,12,Grant Ellis,JR,G,Southern,SWAC,1,7,2,4,1,2,1,2,0,0,0,0,0,0,0,0,1,2,5
Southern California1,1,Jordan McLaughlin,SO,G,Southern California,Pac-12,33,1066,155,333,100,203,55,130,76,102,16,107,123,156,51,5,77,33,441
Southern California2,2,Julian Jacobs,JR,G,Southern California,Pac-12,30,931,125,269,110,223,15,46,88,124,31,116,147,165,38,13,78,77,353
Southern California3,3,Katin Reinhardt,JR,G,Southern California,Pac-12,33,887,142,321,83,164,59,157,34,44,22,69,91,47,35,5,47,34,377
Southern California4,4,Elijah Stewart,SO,G,Southern California,Pac-12,33,866,110,253,52,117,58,136,44,59,25,94,119,36,20,24,28,87,322
Southern California5,5,Nikola Jovanovic,JR,F,Southern California,Pac-12,33,841,149,285,142,272,7,13,94,144,73,158,231,13,11,27,46,79,399
Southern California6,6,Bennie Boatwright,FR,F,Southern California,Pac-12,32,781,117,299,59,135,58,164,75,101,49,119,168,33,13,26,45,102,367
Southern California7,7,Chimezie Metu,FR,F,Southern California,Pac-12,33,618,89,170,89,169,0,1,41,80,52,69,121,17,18,53,36,81,219
Southern California8,8,Darion Clark,JR,F,Southern California,Pac-12,26,289,26,58,26,58,0,0,15,32,43,75,118,8,5,11,22,29,67
Southern California9,9,Malik Marquetti,SO,G,Southern California,Pac-12,26,192,17,47,12,27,5,20,12,19,11,16,27,12,9,5,6,19,51
Southern California10,10,Malik Martin,SO,F,Southern California,Pac-12,26,175,16,35,15,31,1,4,15,26,10,29,39,4,6,9,7,33,48
Southern California11,11,Strahinja Gavrilovic,SR,F,Southern California,Pac-12,18,46,7,15,5,11,2,4,6,6,0,4,4,0,3,1,4,0,22
Southern California12,12,Samer Dhillon,JR,F,Southern California,Pac-12,6,8,1,1,1,1,0,0,0,0,0,0,0,0,0,0,0,2,2
Southern Illinois1,1,Anthony Beane,SR,G,Southern Illinois,MVC,32,1097,208,481,136,287,72,194,129,167,22,101,123,57,36,0,86,88,617
Southern Illinois2,2,Sean O'Brien,JR,F,Southern Illinois,MVC,32,993,156,311,148,271,8,40,67,112,62,130,192,63,28,29,65,80,387
Southern Illinois3,3,Mike Rodriguez,JR,G,Southern Illinois,MVC,32,916,85,204,66,142,19,62,76,121,11,54,65,94,40,2,50,72,265
Southern Illinois4,4,Tyler Smithpeters,JR,G,Southern Illinois,MVC,32,766,62,160,15,44,47,116,52,68,15,77,92,62,35,4,51,95,223
Southern Illinois5,5,Bola Olaniyan,JR,C,Southern Illinois,MVC,29,693,86,152,86,152,0,0,55,83,88,166,254,24,26,6,47,109,227
Southern Illinois6,6,Leo Vincent,JR,G,Southern Illinois,MVC,32,683,82,197,46,88,36,109,60,71,13,52,65,34,25,1,48,48,260
Southern Illinois7,7,Armon Fletcher,FR,G,Southern Illinois,MVC,32,462,60,137,39,72,21,65,22,36,33,42,75,15,20,7,25,65,163
Southern Illinois8,8,Austin Weiher,FR,F,Southern Illinois,MVC,31,333,40,78,34,59,6,19,7,13,13,31,44,8,10,0,17,37,93
Southern Illinois9,9,Ibby Djimde,SR,C,Southern Illinois,MVC,31,276,25,52,25,52,0,0,12,21,26,30,56,10,8,3,18,60,62
Southern Illinois10,10,Rudy Stradnieks,FR,F,Southern Illinois,MVC,24,112,9,23,9,20,0,3,6,11,6,20,26,2,0,3,2,14,24
Southern Illinois11,11,Deng Leek,SR,C,Southern Illinois,MVC,19,57,8,12,8,12,0,0,1,4,7,14,21,0,1,7,4,8,17
Southern Illinois12,12,Sean Lloyd,FR,G,Southern Illinois,MVC,13,38,3,10,2,8,1,2,4,8,4,5,9,1,2,1,2,4,11
Southern Illinois13,13,Jeremy Postell,JR,F,Southern Illinois,MVC,6,9,4,9,2,2,2,7,0,0,0,4,4,0,1,0,2,3,10
Southern Illinois-Edwardsville1,1,Burak Eslik,JR,G,Southern Illinois-Edwardsville,OVC,28,910,108,282,63,149,45,133,131,155,11,61,72,37,13,0,44,44,392
Southern Illinois-Edwardsville2,2,Carlos Anderson,FR,G,Southern Illinois-Edwardsville,OVC,28,883,103,267,71,163,32,104,50,68,32,99,131,66,31,2,56,73,288
Southern Illinois-Edwardsville3,3,C.J. Carr,SO,G,Southern Illinois-Edwardsville,OVC,28,733,77,223,51,130,26,93,31,41,17,58,75,88,28,2,62,57,211
Southern Illinois-Edwardsville4,4,Keenan Simmons,SO,F,Southern Illinois-Edwardsville,OVC,28,602,68,126,67,121,1,5,19,37,59,63,122,6,7,34,20,92,156
Southern Illinois-Edwardsville5,5,Yemi Makanjuola,SR,F,Southern Illinois-Edwardsville,OVC,28,491,63,132,63,130,0,2,55,90,56,99,155,17,9,11,54,95,181
Southern Illinois-Edwardsville6,6,Jalen Henry,SO,F,Southern Illinois-Edwardsville,OVC,28,447,53,138,52,126,1,12,46,65,33,61,94,13,7,24,48,78,153
Southern Illinois-Edwardsville7,7,Grant Fiorentinos,SR,C,Southern Illinois-Edwardsville,OVC,25,406,60,124,60,124,0,0,54,74,28,57,85,11,9,2,30,44,174
Southern Illinois-Edwardsville8,8,Jake Newton,SR,F,Southern Illinois-Edwardsville,OVC,25,356,38,119,7,32,31,87,4,9,8,33,41,17,10,2,16,38,111
Southern Illinois-Edwardsville9,9,Michael Chandler,SR,F,Southern Illinois-Edwardsville,OVC,20,283,22,34,22,34,0,0,6,16,33,28,61,7,5,31,2,35,50
Southern Illinois-Edwardsville10,10,Connor Wheeler,SR,G,Southern Illinois-Edwardsville,OVC,22,251,14,63,6,24,8,39,9,13,3,21,24,22,9,1,12,33,45
Southern Illinois-Edwardsville11,11,Devin Thornton,JR,F,Southern Illinois-Edwardsville,OVC,21,155,11,41,3,21,8,20,5,12,4,12,16,11,6,3,8,20,35
Southern Illinois-Edwardsville12,12,Joshua White,JR,G,Southern Illinois-Edwardsville,OVC,11,133,17,42,11,18,6,24,3,7,3,8,11,8,4,0,11,10,43
Southern Methodist1,1,Nic Moore,SR,G,Southern Methodist,AAC,29,996,153,364,77,180,76,184,84,105,9,61,70,152,39,3,66,64,466
Southern Methodist2,2,Shake Milton,FR,G,Southern Methodist,AAC,30,980,113,237,61,115,52,122,37,51,9,80,89,82,24,8,46,43,315
Southern Methodist3,3,Ben Moore,JR,F,Southern Methodist,AAC,29,863,134,244,134,244,0,0,77,107,84,131,215,64,21,41,46,77,345
Southern Methodist4,4,Sterling Brown,JR,G,Southern Methodist,AAC,30,816,109,181,79,125,30,56,54,63,39,93,132,79,33,13,67,90,302
Southern Methodist5,5,Jordan Tolbert,SR,F,Southern Methodist,AAC,30,799,133,239,131,235,2,4,80,122,106,150,256,25,25,22,39,54,348
Southern Methodist6,6,Markus Kennedy,SR,F,Southern Methodist,AAC,28,646,110,216,108,212,2,4,37,66,59,118,177,61,20,34,48,66,259
Southern Methodist7,7,Jarrey Foster,FR,G,Southern Methodist,AAC,30,523,55,127,42,87,13,40,24,48,42,59,101,40,10,11,28,48,147
Southern Methodist8,8,Keith Frazier,JR,G,Southern Methodist,AAC,10,288,44,98,29,57,15,41,16,20,7,37,44,19,9,5,16,20,119
Southern Methodist9,9,Jonathan Wilfong,JR,G,Southern Methodist,AAC,17,59,3,11,1,5,2,6,0,1,1,4,5,2,1,0,3,8,8
Southern Methodist10,10,David Nelson,SR,G,Southern Methodist,AAC,4,6,2,2,2,2,0,0,0,0,0,1,1,1,0,0,0,0,4
Southern Methodist11,11,Courtland Sutton,FR,F,Southern Methodist,AAC,3,4,1,3,0,1,1,2,0,0,0,2,2,0,0,0,1,2,3
Southern Methodist12,12,Jake Brudish,SO,G,Southern Methodist,AAC,3,3,1,1,0,0,1,1,0,0,0,0,0,1,0,0,0,0,3
Southern Mississippi1,1,Khari Price,JR,G,Southern Mississippi,CUSA,29,859,89,219,49,104,40,115,60,72,17,74,91,131,33,5,61,75,278
Southern Mississippi2,2,Kourtlin Jackson,SR,G,Southern Mississippi,CUSA,28,780,124,274,68,145,56,129,103,134,21,108,129,36,32,8,48,64,407
Southern Mississippi3,3,Quinton Campbell,JR,G,Southern Mississippi,CUSA,29,661,64,163,21,34,43,129,22,33,11,86,97,30,12,4,27,39,193
Southern Mississippi4,4,Keljin Blevins,SO,G,Southern Mississippi,CUSA,29,648,53,156,42,107,11,49,52,81,31,69,100,21,12,7,49,55,169
Southern Mississippi5,5,Raheem Watts,JR,F,Southern Mississippi,CUSA,28,620,74,161,56,105,18,56,45,60,23,65,88,15,15,2,38,90,211
Southern Mississippi6,6,Michael Ramey,JR,G,Southern Mississippi,CUSA,29,488,58,149,21,52,37,97,6,9,3,34,37,11,6,0,15,48,159
Southern Mississippi7,7,Tim Rowe,FR,F,Southern Mississippi,CUSA,29,453,41,96,39,88,2,8,35,59,33,53,86,6,8,25,36,47,119
Southern Mississippi8,8,Cortez Edwards,FR,G,Southern Mississippi,CUSA,29,417,20,68,15,42,5,26,11,12,8,46,54,44,16,3,27,24,56
Southern Mississippi9,9,Michael O'Donnell,SR,F,Southern Mississippi,CUSA,19,392,34,79,16,37,18,42,12,22,20,40,60,19,7,7,21,47,98
Southern Mississippi10,10,Robert Thomas,FR,G,Southern Mississippi,CUSA,29,390,24,65,6,19,18,46,25,34,4,31,35,33,10,0,30,35,91
Southern Mississippi11,11,Eddie Davis,SO,F,Southern Mississippi,CUSA,9,192,31,66,22,42,9,24,14,24,17,34,51,7,5,2,10,19,85
Southern Utah1,1,James McGee,SO,G,Southern Utah,Big Sky,29,788,109,254,30,64,79,190,56,63,7,48,55,48,28,3,40,55,353
Southern Utah2,2,Casey Oliverson,SR,F,Southern Utah,Big Sky,30,765,115,213,114,208,1,5,34,50,42,77,119,14,14,16,29,80,265
Southern Utah3,3,Trey Kennedy,JR,G,Southern Utah,Big Sky,26,709,102,257,70,160,32,97,61,80,10,60,70,65,25,9,51,54,297
Southern Utah4,4,Race Parsons,JR,G,Southern Utah,Big Sky,25,706,70,171,30,66,40,105,33,46,28,77,105,40,12,7,27,56,213
Southern Utah5,5,Travon Langston,SR,G,Southern Utah,Big Sky,28,699,108,222,95,172,13,50,85,119,14,128,142,54,27,4,64,73,314
Southern Utah6,6,John Marshall,JR,G,Southern Utah,Big Sky,30,622,56,127,44,98,12,29,56,75,15,49,64,69,25,2,35,64,180
Southern Utah7,7,Juwan Major,JR,G,Southern Utah,Big Sky,30,615,53,131,53,128,0,3,35,56,19,48,67,37,19,12,58,78,141
Southern Utah8,8,Chris Thompson,SR,G,Southern Utah,Big Sky,29,369,44,127,21,57,23,70,23,32,10,65,75,14,7,7,23,20,134
Southern Utah9,9,Daniel Melifonwu,FR,F,Southern Utah,Big Sky,29,270,14,31,14,31,0,0,6,15,14,31,45,1,2,18,19,60,34
Southern Utah10,10,Paris Davis,JR,G,Southern Utah,Big Sky,23,193,26,55,26,55,0,0,25,39,10,22,32,4,5,1,19,32,77
Southern Utah11,11,Will Joyce,JR,F,Southern Utah,Big Sky,25,156,22,45,22,45,0,0,12,26,25,21,46,3,4,7,6,31,56
Southern Utah12,12,A.J. Hess,SR,G,Southern Utah,Big Sky,6,126,19,38,10,16,9,22,3,4,0,10,10,6,2,0,6,13,50
Southern Utah13,13,Matthew Johnson,FR,G,Southern Utah,Big Sky,10,24,1,10,0,4,1,6,0,0,0,1,1,0,0,0,0,2,3
St. Bonaventure1,1,Marcus Posley,SR,G,St. Bonaventure,A-10,30,1115,192,454,113,238,79,216,128,158,20,83,103,110,37,3,72,73,591
St. Bonaventure2,2,Dion Wright,SR,F,St. Bonaventure,A-10,30,1110,193,413,169,338,24,75,97,122,84,187,271,37,30,23,43,83,507
St. Bonaventure3,3,Jaylen Adams,SO,G,St. Bonaventure,A-10,29,1085,142,317,64,140,78,177,151,173,22,85,107,145,38,8,82,77,513
St. Bonaventure4,4,Idris Taqqee,SO,G,St. Bonaventure,A-10,30,766,58,127,42,83,16,44,17,29,46,73,119,35,24,11,21,81,149
St. Bonaventure5,5,Denzel Gregg,JR,F,St. Bonaventure,A-10,30,700,93,196,78,152,15,44,77,115,54,106,160,23,12,40,36,87,278
St. Bonaventure6,6,Nelson Kaputo,FR,G,St. Bonaventure,A-10,29,499,44,131,9,33,35,98,9,11,3,47,50,55,29,0,30,45,132
St. Bonaventure7,7,Derrick Woods,FR,F,St. Bonaventure,A-10,29,384,42,74,42,73,0,1,21,29,25,46,71,3,4,17,28,68,105
St. Bonaventure8,8,Jordan Tyson,FR,F,St. Bonaventure,A-10,22,361,20,47,20,47,0,0,13,27,22,52,74,0,3,25,22,63,53
St. Bonaventure9,9,LaDarien Griffin,FR,F,St. Bonaventure,A-10,11,30,2,5,2,4,0,1,2,3,3,2,5,0,0,1,3,10,6
St. Francis (NY)1,1,Tyreek Jewell,SR,G,St. Francis (NY),NEC,32,1051,141,365,96,213,45,152,85,129,63,115,178,67,33,8,63,63,412
St. Francis (NY)2,2,Yunus Hopkinson,JR,G,St. Francis (NY),NEC,32,922,118,346,43,139,75,207,80,95,10,71,81,92,27,0,75,55,391
St. Francis (NY)3,3,Amdy Fall,SR,F,St. Francis (NY),NEC,32,786,59,129,58,128,1,1,64,101,74,143,217,25,26,76,48,94,183
St. Francis (NY)4,4,Antonio Jenifer,SR,F,St. Francis (NY),NEC,32,781,87,214,59,115,28,99,65,90,56,142,198,33,18,22,49,90,267
St. Francis (NY)5,5,Chris Hooper,SR,F,St. Francis (NY),NEC,32,682,141,244,141,242,0,2,80,140,61,101,162,48,33,42,76,97,362
St. Francis (NY)6,6,Gunnar Olafsson,SO,G,St. Francis (NY),NEC,27,581,38,97,19,33,19,64,6,10,20,34,54,17,14,3,23,56,101
St. Francis (NY)7,7,Dagur Jonsson,FR,G,St. Francis (NY),NEC,32,542,42,149,18,56,24,93,24,34,7,32,39,43,7,0,38,31,132
St. Francis (NY)8,8,Keon Williams,FR,F,St. Francis (NY),NEC,28,485,26,71,15,31,11,40,11,19,25,42,67,11,16,5,19,38,74
St. Francis (NY)9,9,Jon Doss,SR,F,St. Francis (NY),NEC,24,344,34,97,11,21,23,76,5,11,12,37,49,13,7,2,11,31,96
St. Francis (NY)10,10,Glenn Sanabria,SO,G,St. Francis (NY),NEC,6,145,17,52,7,22,10,30,7,10,2,5,7,19,7,1,10,16,51
St. Francis (NY)11,11,Marlon Alcindor,FR,F,St. Francis (NY),NEC,8,30,5,14,1,5,4,9,3,4,0,2,2,0,0,0,1,3,17
St. Francis (NY)12,12,Jagos Lasic,SO,F,St. Francis (NY),NEC,8,26,2,5,2,2,0,3,0,0,1,5,6,1,1,0,1,6,4
St. John's (NY)1,1,Federico Mussini,FR,G,St. John's (NY),Big East,32,938,103,305,47,121,56,184,81,94,14,66,80,70,38,2,73,41,343
St. John's (NY)2,2,Durand Johnson,SR,F,St. John's (NY),Big East,32,886,131,351,75,180,56,171,67,91,17,106,123,53,39,9,59,91,385
St. John's (NY)3,3,Ron Mvouika,SR,F,St. John's (NY),Big East,32,855,88,221,40,96,48,125,47,71,20,108,128,57,22,7,56,96,271
St. John's (NY)4,4,Christian Jones,JR,F,St. John's (NY),Big East,32,807,110,230,109,227,1,3,48,79,46,121,167,44,27,17,60,67,269
St. John's (NY)5,5,Kassoum Yakwe,FR,F,St. John's (NY),Big East,26,609,66,145,66,145,0,0,53,102,58,80,138,10,17,63,40,83,185
St. John's (NY)6,6,Felix Balamou,SR,G,St. John's (NY),Big East,26,591,71,160,70,155,1,5,35,59,28,57,85,62,18,5,48,71,178
St. John's (NY)7,7,Yankuba Sima,FR,C,St. John's (NY),Big East,25,585,77,157,76,155,1,2,27,70,59,83,142,30,16,57,30,76,182
St. John's (NY)8,8,Malik Ellison,FR,G,St. John's (NY),Big East,24,511,48,130,34,86,14,44,66,101,15,44,59,62,9,2,63,64,176
St. John's (NY)9,9,Amar Alibegovic,SO,F,St. John's (NY),Big East,32,510,56,142,30,56,26,86,24,39,19,58,77,22,15,9,49,80,162
St. John's (NY)10,10,Darien Williams,JR,F,St. John's (NY),Big East,3,49,2,6,0,0,2,6,3,4,1,8,9,0,0,2,3,4,9
St. John's (NY)11,11,Elijah Holifield,FR,G,St. John's (NY),Big East,10,39,2,12,1,5,1,7,1,2,1,3,4,1,1,0,1,3,6
St. John's (NY)12,12,Abdul Dial,FR,G,St. John's (NY),Big East,6,20,3,5,3,5,0,0,2,2,1,3,4,2,0,0,0,4,8
Stanford1,1,Rosco Allen,SR,F,Stanford,Pac-12,30,1018,142,335,86,169,56,166,127,172,48,146,194,50,35,5,60,84,467
Stanford2,2,Dorian Pickens,SO,G,Stanford,Pac-12,30,880,117,280,65,136,52,144,84,114,41,68,109,56,31,4,33,65,370
Stanford3,3,Marcus Allen,JR,G,Stanford,Pac-12,28,848,101,246,83,171,18,75,90,124,35,73,108,52,39,1,45,70,310
Stanford4,4,Michael Humphrey,SO,F,Stanford,Pac-12,30,726,128,260,119,232,9,28,45,70,57,134,191,23,30,38,45,95,310
Stanford5,5,Christian Sanders,SR,G,Stanford,Pac-12,27,605,32,106,25,70,7,36,44,53,6,54,60,70,16,0,42,41,115
Stanford6,6,Marcus Sheffield,FR,G,Stanford,Pac-12,28,447,56,145,39,100,17,45,40,57,16,47,63,28,13,2,32,40,169
Stanford7,7,Grant Verhoeven,SR,C,Stanford,Pac-12,27,399,32,73,27,64,5,9,21,32,29,26,55,6,11,13,12,78,90
Stanford8,8,Malcolm Allen,JR,G,Stanford,Pac-12,28,358,28,61,22,43,6,18,6,14,2,20,22,33,12,1,32,22,68
Stanford9,9,Cameron Walker,FR,F,Stanford,Pac-12,25,275,7,24,6,18,1,6,19,39,10,22,32,23,5,2,18,40,34
Stanford10,10,Reid Travis,SO,F,Stanford,Pac-12,8,262,39,70,39,70,0,0,24,50,26,31,57,6,6,5,17,19,102
Stanford11,11,Josh Sharma,FR,C,Stanford,Pac-12,26,205,22,46,21,40,1,6,5,13,13,27,40,3,5,23,6,43,50
Stephen F. Austin1,1,Thomas Walkup,SR,F,Stephen F. Austin,Southland,32,938,204,341,196,307,8,34,144,181,74,145,219,144,67,14,56,87,560
Stephen F. Austin2,2,Trey Pinkney,SR,G,Stephen F. Austin,Southland,32,820,25,56,19,34,6,22,31,44,8,47,55,116,49,1,28,76,87
Stephen F. Austin3,3,Ty Charles,SO,G,Stephen F. Austin,Southland,31,785,110,246,89,177,21,69,61,82,55,100,155,73,41,10,59,83,302
Stephen F. Austin4,4,Demetrious Floyd,SR,G,Stephen F. Austin,Southland,32,778,164,348,70,129,94,219,21,29,9,40,49,47,36,3,29,42,443
Stephen F. Austin5,5,Clide Geffrard,SR,F,Stephen F. Austin,Southland,32,767,145,286,102,169,43,117,95,117,64,124,188,46,27,18,55,72,428
Stephen F. Austin6,6,T.J. Holyfield,FR,F,Stephen F. Austin,Southland,32,644,89,174,74,134,15,40,44,61,51,85,136,34,25,46,61,107,237
Stephen F. Austin7,7,Dallas Cameron,JR,G,Stephen F. Austin,Southland,32,571,37,105,23,55,14,50,28,40,12,19,31,55,11,5,17,46,116
Stephen F. Austin8,8,Jared Johnson,SR,G,Stephen F. Austin,Southland,32,366,69,172,23,53,46,119,14,23,8,22,30,38,12,1,28,51,198
Stephen F. Austin9,9,C.J. Williams,JR,F,Stephen F. Austin,Southland,29,279,27,60,27,59,0,1,18,34,20,55,75,30,8,0,27,42,72
Stephen F. Austin10,10,Nathan Bain,FR,F,Stephen F. Austin,Southland,24,179,22,43,21,39,1,4,14,27,17,32,49,11,8,7,9,18,59
Stephen F. Austin11,11,Jovan Grujic,FR,C,Stephen F. Austin,Southland,24,148,14,35,14,32,0,3,4,6,12,19,31,6,2,5,9,20,32
Stephen F. Austin12,12,Lasani Johnson,FR,G,Stephen F. Austin,Southland,18,79,12,27,6,14,6,13,0,1,2,5,7,3,2,1,5,9,30
Stephen F. Austin13,13,JaQuan Smith,JR,F,Stephen F. Austin,Southland,17,45,8,20,8,20,0,0,3,8,6,10,16,1,2,3,3,7,19
Stetson1,1,Divine Myles,SO,G,Stetson,A-Sun,34,1103,175,342,149,274,26,68,94,142,22,132,154,143,46,4,57,76,470
Stetson2,2,Derick Newton,FR,F,Stetson,A-Sun,34,1061,171,384,114,262,57,122,154,186,52,148,200,46,15,15,81,63,553
Stetson3,3,Brian Pegg,JR,G,Stetson,A-Sun,34,975,185,321,185,321,0,0,60,119,114,218,332,37,31,35,79,109,430
Stetson4,4,Luke Doyle,SO,G,Stetson,A-Sun,34,832,113,251,41,72,72,179,34,42,8,86,94,56,26,5,27,54,332
Stetson5,5,Angel Rivera,SO,G,Stetson,A-Sun,34,802,61,143,47,92,14,51,83,108,18,55,73,150,40,2,47,80,219
Stetson6,6,Cameron Harvey,JR,G,Stetson,A-Sun,34,683,65,189,24,77,41,112,28,36,8,37,45,15,8,2,23,41,199
Stetson7,7,Grant Lozoya,SO,G,Stetson,A-Sun,31,654,84,221,57,103,27,118,32,43,2,76,78,49,28,6,54,101,227
Stetson8,8,Leo Goodman,FR,F,Stetson,A-Sun,34,547,80,190,41,90,39,100,24,28,31,45,76,12,15,5,20,55,223
Stetson9,9,Ty Cockfield,FR,G,Stetson,A-Sun,9,149,24,62,18,40,6,22,10,12,5,12,17,8,5,2,13,6,64
Stetson10,10,Drew Romich,FR,F,Stetson,A-Sun,17,77,1,8,1,8,0,0,1,3,6,2,8,3,1,2,3,12,3
Stetson11,11,Kevin Ndahiro,FR,C,Stetson,A-Sun,7,51,3,10,3,10,0,0,1,4,3,9,12,0,0,5,5,13,7
Stony Brook1,1,Carson Puriefoy,SR,G,Stony Brook,AEC,32,1077,153,381,72,179,81,202,96,125,21,83,104,99,40,12,78,73,483
Stony Brook2,2,Jameel Warney,SR,F,Stony Brook,AEC,32,1052,262,412,262,412,0,0,108,173,141,201,342,52,31,96,41,69,632
Stony Brook3,3,Ahmad Walker,JR,G,Stony Brook,AEC,32,931,111,247,96,183,15,64,97,140,48,167,215,136,33,8,101,91,334
Stony Brook4,4,Rayshaun McGrew,SR,F,Stony Brook,AEC,31,854,150,293,150,289,0,4,34,75,59,127,186,39,17,10,38,63,334
Stony Brook5,5,Lucas Woodhouse,JR,G,Stony Brook,AEC,30,791,65,143,18,39,47,104,25,29,5,72,77,109,30,1,36,43,202
Stony Brook6,6,Bryan Sekunda,SO,G,Stony Brook,AEC,25,500,64,159,17,41,47,118,7,9,11,29,40,34,10,1,17,24,182
Stony Brook7,7,Tyrell Sturdivant,SO,F,Stony Brook,AEC,32,379,40,86,39,85,1,1,18,27,51,65,116,19,19,9,19,56,99
Stony Brook8,8,Roland Nyama,SO,G,Stony Brook,AEC,30,304,30,71,15,32,15,39,20,26,10,36,46,13,5,6,13,38,95
Stony Brook9,9,Kameron Mitchell,JR,G,Stony Brook,AEC,25,221,10,35,3,14,7,21,1,3,4,10,14,13,7,0,8,22,28
Stony Brook10,10,Deshaun Thrower,SO,G,Stony Brook,AEC,26,216,17,64,14,36,3,28,7,9,3,14,17,13,4,1,6,20,44
Stony Brook11,11,Jakub Petras,SO,F,Stony Brook,AEC,20,89,10,20,10,20,0,0,2,3,8,12,20,4,2,3,2,10,22
Stony Brook12,12,Tim Donohoe,SO,G,Stony Brook,AEC,3,11,1,5,0,1,1,4,0,0,0,0,0,0,0,0,0,0,3
Syracuse1,1,Michael Gbinije,SR,F,Syracuse,ACC,32,1212,195,409,110,202,85,207,96,143,35,95,130,141,62,10,92,88,571
Syracuse2,2,Trevor Cooney,SR,G,Syracuse,ACC,32,1167,124,373,43,136,81,237,80,100,18,59,77,72,52,5,51,47,409
Syracuse3,3,Malachi Richardson,FR,G,Syracuse,ACC,32,1093,130,348,62,154,68,194,93,132,13,124,137,72,37,9,65,75,421
Syracuse4,4,Tyler Roberson,JR,F,Syracuse,ACC,32,972,117,225,117,223,0,2,49,90,121,134,255,44,22,22,49,76,283
Syracuse5,5,Tyler Lydon,FR,F,Syracuse,ACC,32,970,112,229,69,126,43,103,57,72,55,148,203,40,36,47,41,87,324
Syracuse6,6,DaJuan Coleman,SR,C,Syracuse,ACC,32,569,62,112,62,112,0,0,40,60,60,86,146,14,23,26,40,92,164
Syracuse7,7,Franklin Howard,FR,G,Syracuse,ACC,27,285,15,53,14,37,1,16,12,24,9,30,39,49,14,3,24,31,43
Syracuse8,8,Kaleb Joseph,SO,G,Syracuse,ACC,18,114,5,28,3,15,2,13,4,5,5,4,9,12,8,1,6,10,16
Syracuse9,9,Chinonso Obokoh,SR,C,Syracuse,ACC,11,67,5,8,5,8,0,0,2,7,4,14,18,1,3,5,3,21,12
Syracuse10,10,Ky Feldman,FR,G,Syracuse,ACC,2,2,1,1,1,1,0,0,0,0,0,1,1,0,1,0,0,0,2
Temple1,1,Josh Brown,JR,G,Temple,AAC,32,1150,92,229,67,154,25,75,50,68,12,138,150,157,41,14,44,63,259
Temple2,2,Quenton DeCosey,SR,G,Temple,AAC,32,1102,154,385,106,254,48,131,144,186,41,150,191,84,41,13,68,61,500
Temple3,3,Jaylen Bond,SR,F,Temple,AAC,30,862,142,300,139,276,3,24,19,49,98,150,248,42,32,12,39,89,306
Temple4,4,Devin Coleman,SR,G,Temple,AAC,32,813,104,283,40,123,64,160,27,37,30,64,94,33,12,4,26,41,299
Temple5,5,Obi Enechionyia,SO,F,Temple,AAC,31,776,124,290,68,148,56,142,44,64,31,84,115,16,11,29,28,83,348
Temple6,6,Daniel Dingle,JR,G,Temple,AAC,32,678,48,146,33,84,15,62,33,60,32,60,92,49,13,14,27,63,144
Temple7,7,Trey Lowe,FR,G,Temple,AAC,28,342,51,128,34,62,17,66,15,19,15,29,44,16,13,1,11,16,134
Temple8,8,Levan Shawn Alston,FR,G,Temple,AAC,30,308,23,74,10,26,13,48,4,8,4,25,29,18,3,1,11,28,63
Temple9,9,Mark Williams,JR,F,Temple,AAC,30,272,40,91,30,60,10,31,17,24,22,29,51,15,1,4,19,40,107
Temple10,10,Ernest Aflakpui,FR,C,Temple,AAC,17,135,12,23,12,23,0,0,7,11,16,20,36,2,3,6,5,20,31
Temple11,11,Devontae Watson,SR,F,Temple,AAC,10,54,2,5,2,5,0,0,0,0,2,7,9,0,1,1,2,10,4
Tennessee1,1,Armani Moore,SR,F,Tennessee,SEC,33,1080,149,360,131,303,18,57,87,154,64,186,250,134,39,54,86,91,403
Tennessee2,2,Devon Baulkman,SR,G,Tennessee,SEC,34,933,109,292,47,106,62,186,44,54,50,67,117,60,35,13,45,56,324
Tennessee3,3,Kevin Punter,SR,G,Tennessee,SEC,26,886,177,385,119,228,58,157,165,202,5,84,89,91,36,6,66,73,577
Tennessee4,4,Robert Hubbs,JR,G,Tennessee,SEC,30,801,128,283,117,237,11,46,51,69,47,70,117,38,13,1,22,47,318
Tennessee5,5,Detrick Mostella,SO,G,Tennessee,SEC,34,667,95,262,48,107,47,155,50,68,14,60,74,40,9,6,46,66,287
Tennessee6,6,Derek Reese,SR,F,Tennessee,SEC,34,653,40,86,33,71,7,15,20,37,61,123,184,29,17,20,18,64,107
Tennessee7,7,Admiral Schofield,FR,F,Tennessee,SEC,32,598,92,207,67,124,25,83,35,39,43,86,129,29,12,10,23,88,244
Tennessee8,8,Shembari Phillips,FR,G,Tennessee,SEC,33,535,60,147,39,90,21,57,36,47,14,47,61,32,8,5,45,72,177
Tennessee9,9,Kyle Alexander,FR,F,Tennessee,SEC,32,390,16,37,16,37,0,0,21,32,49,52,101,2,5,31,15,55,53
Tennessee10,10,Ray Kasongo,SO,F,Tennessee,SEC,22,121,12,23,12,23,0,0,7,11,13,19,32,1,1,7,6,26,31
Tennessee11,11,Jabari McGhee,FR,F,Tennessee,SEC,6,65,9,17,9,17,0,0,5,6,8,11,19,0,4,3,1,17,23
Tennessee12,12,Brad Woodson,FR,G,Tennessee,SEC,10,63,2,14,1,5,1,9,2,2,3,5,8,3,1,0,2,6,7
Tennessee13,13,Lucas Campbell,FR,G,Tennessee,SEC,4,8,1,3,0,1,1,2,0,0,0,1,1,0,0,0,1,1,3
Tennessee State1,1,Keron DeShields,SR,G,Tennessee State,OVC,29,938,159,366,116,241,43,125,110,149,10,87,97,88,37,5,60,73,471
Tennessee State2,2,Tahjere McCall,SR,G,Tennessee State,OVC,30,891,133,292,114,224,19,68,155,204,44,108,152,89,68,11,95,98,440
Tennessee State3,3,Wayne Martin,JR,F,Tennessee State,OVC,29,730,126,252,125,239,1,13,70,112,92,169,261,8,19,33,60,78,323
Tennessee State4,4,Darreon Reddick,SO,G,Tennessee State,OVC,30,697,53,163,30,79,23,84,43,53,9,49,58,40,15,0,37,38,172
Tennessee State5,5,Demontez Loman,SR,F,Tennessee State,OVC,30,695,58,104,58,104,0,0,21,40,62,108,170,12,34,27,28,91,137
Tennessee State6,6,Marcus Roper,SR,G,Tennessee State,OVC,30,555,78,183,36,69,42,114,31,43,9,40,49,14,16,7,14,52,229
Tennessee State7,7,Christian Griggs-Williams,SR,F,Tennessee State,OVC,29,443,45,89,33,65,12,24,12,22,32,47,79,7,8,3,27,40,114
Tennessee State8,8,Xavier Richards,SR,G,Tennessee State,OVC,29,441,56,84,55,81,1,3,23,43,28,61,89,20,14,14,22,56,136
Tennessee State9,9,Armani Chaney,FR,G,Tennessee State,OVC,22,278,31,81,25,61,6,20,18,25,4,22,26,31,15,1,26,30,86
Tennessee State10,10,Samson Oyediran,FR,F,Tennessee State,OVC,22,158,11,24,8,12,3,12,3,8,11,15,26,1,1,0,14,37,28
Tennessee State11,11,Johnny Woodard,JR,G,Tennessee State,OVC,7,117,13,33,1,4,12,29,4,5,3,12,15,5,1,1,8,10,42
Tennessee State12,12,Neville Fincher,JR,C,Tennessee State,OVC,18,106,8,21,7,18,1,3,5,8,4,18,22,1,3,5,7,18,22
Tennessee Tech1,1,Torrance Rowe,SR,G,Tennessee Tech,OVC,30,1068,168,414,89,185,79,229,127,146,14,69,83,135,18,2,78,33,542
Tennessee Tech2,2,Aleksa Jugovic,SO,G,Tennessee Tech,OVC,30,955,118,262,48,97,70,165,64,74,2,66,68,88,26,1,47,52,370
Tennessee Tech3,3,Ryan Martin,SR,F,Tennessee Tech,OVC,30,861,131,244,115,193,16,51,148,191,71,171,242,35,18,20,60,105,426
Tennessee Tech4,4,Anthony Morse,SR,F,Tennessee Tech,OVC,30,689,88,146,88,145,0,1,55,94,65,115,180,11,16,58,31,106,231
Tennessee Tech5,5,Shirmane Thomas,JR,G,Tennessee Tech,OVC,29,628,37,102,30,74,7,28,26,48,21,83,104,70,24,8,45,57,107
Tennessee Tech6,6,Hakeem Rogers,JR,G,Tennessee Tech,OVC,29,539,88,219,32,76,56,143,54,64,6,57,63,30,22,3,39,50,286
Tennessee Tech7,7,Mason Ramsey,SO,F,Tennessee Tech,OVC,30,488,64,128,53,92,11,36,36,48,25,49,74,13,16,10,18,88,175
Tennessee Tech8,8,Courtney Alexander II,FR,F,Tennessee Tech,OVC,28,296,21,41,21,41,0,0,5,22,23,54,77,12,4,12,19,39,47
Tennessee Tech9,9,Tre Hansbrough,FR,G,Tennessee Tech,OVC,22,184,20,47,14,27,6,20,20,27,2,22,24,21,4,1,10,17,66
Tennessee Tech10,10,Markell Henderson,SO,G,Tennessee Tech,OVC,20,117,16,33,10,17,6,16,3,6,10,20,30,2,4,2,5,15,41
Tennessee Tech11,11,Savonte Frazier,FR,G,Tennessee Tech,OVC,15,113,11,18,8,12,3,6,13,20,1,19,20,14,5,0,11,13,38
Tennessee Tech12,12,Josiah Moore,SR,F,Tennessee Tech,OVC,4,63,6,19,4,11,2,8,4,7,2,10,12,1,1,0,4,4,18
Tennessee Tech13,13,Conner Hall,FR,G,Tennessee Tech,OVC,5,25,3,8,0,1,3,7,1,2,1,0,1,0,0,0,3,5,10
Tennessee-Martin1,1,Twymond Howard,SR,F,Tennessee-Martin,OVC,32,1064,174,385,154,327,20,58,129,174,38,184,222,79,22,13,74,76,497
Tennessee-Martin2,2,Alex Anderson,SR,G,Tennessee-Martin,OVC,33,1056,121,327,34,81,87,246,54,64,9,81,90,67,12,0,40,27,383
Tennessee-Martin3,3,Myles Taylor,SR,F,Tennessee-Martin,OVC,33,850,133,214,130,206,3,8,123,156,74,117,191,30,25,19,61,116,392
Tennessee-Martin4,4,Jacolby Mobley,JR,G,Tennessee-Martin,OVC,32,818,118,285,56,105,62,180,53,64,17,63,80,53,24,5,50,72,351
Tennessee-Martin5,5,Kedar Edwards,JR,F,Tennessee-Martin,OVC,29,703,87,214,64,130,23,84,37,65,84,128,212,49,45,12,54,53,234
Tennessee-Martin6,6,Richard Lee,SO,G,Tennessee-Martin,OVC,33,557,66,149,26,57,40,92,14,20,9,45,54,13,11,1,18,33,186
Tennessee-Martin7,7,Terrence Durham,SR,G,Tennessee-Martin,OVC,29,449,21,59,13,26,8,33,16,28,8,36,44,55,16,0,31,47,66
Tennessee-Martin8,8,Jalen Variste,JR,G,Tennessee-Martin,OVC,26,356,29,73,27,65,2,8,16,27,4,35,39,32,20,0,12,33,76
Tennessee-Martin9,9,Chandler Rowe,JR,F,Tennessee-Martin,OVC,30,335,23,44,21,40,2,4,17,33,32,46,78,12,10,5,18,60,65
Tennessee-Martin10,10,Javier Martinez,JR,F,Tennessee-Martin,OVC,24,173,28,44,28,44,0,0,5,8,21,22,43,4,1,2,16,24,61
Tennessee-Martin11,11,Fatodd Lewis,FR,F,Tennessee-Martin,OVC,18,148,16,45,12,28,4,17,5,14,8,20,28,2,3,5,9,20,41
Tennessee-Martin12,12,Malik London,JR,F,Tennessee-Martin,OVC,12,84,9,14,9,14,0,0,0,6,9,16,25,2,1,3,7,18,18
Tennessee-Martin13,13,James Harrison,JR,G,Tennessee-Martin,OVC,13,72,7,23,2,7,5,16,5,8,3,10,13,2,1,0,4,2,24
Tennessee-Martin14,14,Nick Detlev,FR,C,Tennessee-Martin,OVC,6,10,1,3,1,3,0,0,2,4,0,2,2,0,0,2,0,1,4
Texas1,1,Isaiah Taylor,SO,G,Texas,Big 12,32,982,154,368,138,310,16,58,150,185,14,74,88,158,29,7,58,85,474
Texas2,2,Connor Lammert,JR,F,Texas,Big 12,32,903,76,189,28,50,48,139,27,33,45,124,169,29,19,14,22,85,227
Texas3,3,Javan Felix,JR,G,Texas,Big 12,32,855,121,280,77,156,44,124,54,64,15,39,54,71,26,0,35,62,340
Texas4,4,Eric Davis Jr.,FR,G,Texas,Big 12,32,649,75,206,36,101,39,105,43,54,11,66,77,21,13,0,26,39,232
Texas5,5,Kerwin Roach Jr.,FR,G,Texas,Big 12,32,583,75,166,56,110,19,56,73,116,17,76,93,40,29,8,51,81,242
Texas6,6,Prince Ibeh,JR,C,Texas,Big 12,31,559,52,89,52,89,0,0,27,65,72,87,159,2,9,61,38,101,131
Texas7,7,Tevin Mack,FR,G,Texas,Big 12,32,437,51,175,17,62,34,113,32,50,19,46,65,11,8,9,18,41,168
Texas8,8,Demarcus Holland,JR,G,Texas,Big 12,31,436,33,78,26,52,7,26,18,39,23,27,50,12,14,3,20,41,91
Texas9,9,Shaquille Cleare,JR,F,Texas,Big 12,32,399,49,88,49,88,0,0,22,35,34,61,95,4,3,1,21,59,120
Texas10,10,Kendal Yancy,SO,G,Texas,Big 12,29,318,34,75,23,48,11,27,10,23,16,38,54,13,9,0,9,28,89
Texas11,11,Cameron Ridley,JR,C,Texas,Big 12,12,288,60,96,60,96,0,0,22,53,44,66,110,6,6,37,27,37,142
Texas12,12,Jordan Barnett,FR,F,Texas,Big 12,4,24,4,7,2,3,2,4,3,4,2,6,8,0,0,0,1,3,13
Texas13,13,Ryan McClurg,SO,F,Texas,Big 12,3,8,2,2,2,2,0,0,0,1,3,1,4,0,0,0,0,1,4
Texas14,14,Danny Newsome,SO,F,Texas,Big 12,3,6,3,7,0,2,3,5,0,0,0,0,0,0,0,0,0,1,9
Texas A&M1,1,Danuel House,SR,G,Texas A&M,SEC,33,1011,166,424,96,196,70,228,107,152,36,122,158,73,18,11,56,44,509
Texas A&M2,2,Alex Caruso,SR,G,Texas A&M,SEC,34,967,96,194,70,126,26,68,47,58,35,82,117,173,69,13,75,84,265
Texas A&M3,3,Anthony Collins,SR,G,Texas A&M,SEC,34,874,48,127,23,72,25,55,34,39,7,43,50,146,33,4,48,65,155
Texas A&M4,4,Jalen Jones,SR,G,Texas A&M,SEC,30,820,164,381,135,290,29,91,109,150,58,158,216,19,20,9,43,84,466
Texas A&M5,5,Tyler Davis,FR,C,Texas A&M,SEC,33,755,134,209,134,209,0,0,98,152,98,104,202,24,20,38,55,89,366
Texas A&M6,6,Admon Gilder,FR,G,Texas A&M,SEC,34,667,81,187,47,95,34,92,36,51,15,61,76,47,31,5,24,52,232
Texas A&M7,7,DJ Hogg,FR,F,Texas A&M,SEC,34,621,76,193,32,66,44,127,18,28,23,69,92,32,19,4,21,41,214
Texas A&M8,8,Tonny Trocha-Morelos,SO,C,Texas A&M,SEC,34,587,96,203,67,132,29,71,21,43,57,88,145,33,12,23,27,62,242
Texas A&M9,9,Tavario Miller,JR,F,Texas A&M,SEC,33,368,23,51,23,51,0,0,24,46,41,84,125,12,9,12,29,60,70
Texas A&M10,10,Elijah Thomas,FR,F,Texas A&M,SEC,8,79,12,19,12,19,0,0,6,18,5,15,20,6,0,8,9,23,30
Texas A&M11,11,Kobie Eubanks,FR,G,Texas A&M,SEC,6,30,3,9,0,1,3,8,0,0,2,8,10,2,3,0,1,2,9
Texas A&M12,12,Kyle Dobbins,SR,G,Texas A&M,SEC,14,27,3,6,3,6,0,0,8,15,1,1,2,5,0,0,5,1,14
Texas A&M13,13,Juan Aparicio,SR,G,Texas A&M,SEC,12,21,2,6,1,3,1,3,0,2,0,0,0,1,0,1,1,4,5
Texas A&M14,14,Frank Byers,FR,G,Texas A&M,SEC,8,9,2,4,2,3,0,1,0,1,0,0,0,0,1,0,0,1,4
Texas A&M-Corpus Christi1,1,Brandon Pye,SR,G,Texas A&M-Corpus Christi,Southland,32,982,108,280,36,96,72,184,29,35,10,39,49,39,29,0,24,40,317
Texas A&M-Corpus Christi2,2,Hameed Ali,SR,G,Texas A&M-Corpus Christi,Southland,32,977,112,328,78,212,34,116,96,120,17,69,86,170,88,4,65,80,354
Texas A&M-Corpus Christi3,3,Rashawn Thomas,JR,F,Texas A&M-Corpus Christi,Southland,32,846,200,362,196,346,4,16,127,185,95,164,259,34,30,73,101,124,531
Texas A&M-Corpus Christi4,4,Jelani Currie,SR,G,Texas A&M-Corpus Christi,Southland,32,743,58,156,46,109,12,47,37,55,36,71,107,34,21,9,34,62,165
Texas A&M-Corpus Christi5,5,Bryce Douvier,SR,F,Texas A&M-Corpus Christi,Southland,32,735,102,208,79,145,23,63,98,126,63,150,213,21,29,25,55,102,325
Texas A&M-Corpus Christi6,6,Joe Kilgore,SO,G,Texas A&M-Corpus Christi,Southland,32,613,76,171,64,134,12,37,57,77,29,55,84,33,14,21,37,50,221
Texas A&M-Corpus Christi7,7,Ehab Amin,SO,G,Texas A&M-Corpus Christi,Southland,32,579,97,204,73,137,24,67,54,75,38,88,126,48,59,5,53,64,272
Texas A&M-Corpus Christi8,8,Dale Francis,SR,F,Texas A&M-Corpus Christi,Southland,30,335,20,52,9,12,11,40,5,6,12,31,43,5,10,5,9,71,56
Texas A&M-Corpus Christi9,9,Emmanuel Toney,JR,G,Texas A&M-Corpus Christi,Southland,26,252,11,24,8,16,3,8,10,15,6,20,26,17,13,2,11,37,35
Texas A&M-Corpus Christi10,10,Viktor Juricek,SR,F,Texas A&M-Corpus Christi,Southland,27,188,19,40,9,16,10,24,1,4,8,13,21,2,3,3,10,31,49
Texas A&M-Corpus Christi11,11,Jake Kocher,JR,G,Texas A&M-Corpus Christi,Southland,12,100,9,19,8,14,1,5,6,8,3,17,20,4,7,0,1,13,25
Texas A&M-Corpus Christi12,12,Kareem South,FR,F,Texas A&M-Corpus Christi,Southland,5,36,2,12,2,10,0,2,2,2,5,0,5,3,0,0,3,6,6
Texas Christian1,1,Brandon Parrish,JR,G,Texas Christian,Big 12,33,1022,100,237,56,131,44,106,43,73,25,89,114,44,17,12,54,77,287
Texas Christian2,2,Chauncey Collins,SO,G,Texas Christian,Big 12,32,992,105,271,39,104,66,167,116,148,17,79,96,63,25,3,65,85,392
Texas Christian3,3,Malique Trent,SO,G,Texas Christian,Big 12,30,852,117,301,84,170,33,131,80,128,10,79,89,82,63,8,84,91,347
Texas Christian4,4,Michael Williams,JR,G,Texas Christian,Big 12,28,743,42,119,30,70,12,49,21,30,9,50,59,74,12,2,32,66,117
Texas Christian5,5,Vladimir Brodziansky,SO,F,Texas Christian,Big 12,33,720,120,231,106,188,14,43,66,96,58,92,150,18,8,34,41,71,320
Texas Christian6,6,JD Miller,FR,F,Texas Christian,Big 12,33,640,72,189,66,169,6,20,73,103,63,78,141,21,26,18,50,52,223
Texas Christian7,7,Karviar Shepherd,JR,F,Texas Christian,Big 12,29,594,77,196,72,180,5,16,48,71,46,106,152,24,14,21,46,73,207
Texas Christian8,8,Chris Washburn,JR,F,Texas Christian,Big 12,22,535,48,137,44,126,4,11,46,84,28,66,94,39,27,21,51,68,146
Texas Christian9,9,Devonta Abron,SR,F,Texas Christian,Big 12,26,318,39,90,39,90,0,0,47,72,46,54,100,6,15,7,23,60,125
Texas Christian10,10,Lyrik Shreiner,FR,G,Texas Christian,Big 12,22,117,12,31,9,17,3,14,12,15,3,10,13,9,3,0,13,18,39
Texas Christian11,11,Dalton Dry,SO,G,Texas Christian,Big 12,16,67,2,8,2,7,0,1,2,6,5,4,9,2,3,0,6,14,6
Texas Southern1,1,Chris Thomas,SR,F,Texas Southern,SWAC,32,1084,178,351,164,298,14,53,102,195,55,106,161,136,30,11,119,98,472
Texas Southern2,2,David Blanks,SR,G,Texas Southern,SWAC,32,1048,107,271,82,181,25,90,91,140,31,116,147,144,32,4,95,66,330
Texas Southern3,3,Malcolm Riley,SR,F,Texas Southern,SWAC,32,1014,169,371,94,168,75,203,90,115,52,125,177,29,15,4,47,60,503
Texas Southern4,4,Derrick Griffin,FR,F,Texas Southern,SWAC,26,880,136,207,136,204,0,3,69,133,127,163,290,16,19,57,29,71,341
Texas Southern5,5,Orlando Coleman,FR,F,Texas Southern,SWAC,32,801,74,194,36,73,38,121,21,28,37,94,131,24,16,13,27,47,207
Texas Southern6,6,Jose Rodriguez,SR,F,Texas Southern,SWAC,31,628,93,217,59,137,34,80,53,70,28,73,101,40,13,5,45,82,273
Texas Southern7,7,Tyree Bynum,JR,G,Texas Southern,SWAC,25,333,23,54,8,15,15,39,4,7,4,18,22,8,6,0,9,11,65
Texas Southern8,8,Brian Carey,FR,G,Texas Southern,SWAC,22,302,14,55,9,39,5,16,27,36,2,21,23,35,8,0,21,19,60
Texas Southern9,9,Jerron Martin,JR,G,Texas Southern,SWAC,20,204,20,50,8,15,12,35,4,7,3,16,19,21,4,0,16,12,56
Texas Southern10,10,Jermaine Davis II,JR,C,Texas Southern,SWAC,5,58,1,7,0,5,1,2,7,10,2,7,9,2,0,0,6,9,10
Texas Southern11,11,Joshua Friar,SR,F,Texas Southern,SWAC,3,31,2,4,2,4,0,0,2,6,2,5,7,1,0,2,0,6,6
Texas Southern12,12,Christian McCoggle,JR,C,Texas Southern,SWAC,5,15,1,4,1,4,0,0,3,5,3,2,5,0,0,0,0,1,5
Texas Southern13,13,Eric Washington Jr.,SR,F,Texas Southern,SWAC,4,3,1,2,1,2,0,0,0,0,0,2,2,0,0,0,0,0,2
Texas State1,1,Ojai Black,JR,G,Texas State,Sun Belt,31,969,80,202,74,168,6,34,57,79,12,56,68,120,41,9,43,85,223
Texas State2,2,Kavin Gilder-Tilbury,JR,F,Texas State,Sun Belt,31,890,130,282,86,165,44,117,77,107,42,82,124,55,31,13,69,88,381
Texas State3,3,Ethan Montalvo,SR,G,Texas State,Sun Belt,29,849,95,258,35,86,60,172,53,65,4,53,57,33,28,0,33,30,303
Texas State4,4,Emani Gant,SR,F,Texas State,Sun Belt,29,790,152,302,152,300,0,2,93,129,77,145,222,41,23,15,52,68,397
Texas State5,5,Cameron Naylor,SR,F,Texas State,Sun Belt,30,746,109,232,104,221,5,11,65,99,36,123,159,20,17,8,46,77,288
Texas State6,6,Anthony Roberson,SO,G,Texas State,Sun Belt,29,620,50,94,48,86,2,8,33,64,63,83,146,19,19,17,22,77,135
Texas State7,7,Bobby Conley,JR,G,Texas State,Sun Belt,31,442,31,97,20,60,11,37,14,25,10,44,54,38,10,7,20,29,87
Texas State8,8,Maljhum McCrea,JR,F,Texas State,Sun Belt,28,254,32,78,32,75,0,3,10,30,25,41,66,6,1,8,23,47,74
Texas State9,9,K.J. Malveau,FR,G,Texas State,Sun Belt,31,250,16,52,5,18,11,34,12,15,1,21,22,17,8,0,23,18,55
Texas State10,10,Kendell Ramlal,JR,F,Texas State,Sun Belt,25,212,12,31,12,31,0,0,5,12,20,21,41,6,6,15,16,31,29
Texas State11,11,D'Angelo West,FR,G,Texas State,Sun Belt,19,99,8,30,2,6,6,24,6,8,2,10,12,3,1,1,5,11,28
Texas State12,12,Courtney Julien,FR,G,Texas State,Sun Belt,15,60,7,19,3,7,4,12,7,8,2,4,6,1,3,1,1,4,25
Texas State13,13,Nathan Josephs,FR,G,Texas State,Sun Belt,11,37,2,12,2,7,0,5,6,8,0,1,1,6,1,0,3,2,10
Texas State14,14,Austin Evans,SO,F,Texas State,Sun Belt,14,32,3,3,3,3,0,0,5,9,2,6,8,1,0,2,2,9,11
Texas Tech1,1,Zach Smith,SO,F,Texas Tech,Big 12,31,1012,115,227,111,205,4,22,79,118,57,173,230,55,27,45,47,51,313
Texas Tech2,2,Toddrick Gotcher,SR,G,Texas Tech,Big 12,31,898,108,253,46,98,62,155,66,77,31,80,111,70,32,10,25,67,344
Texas Tech3,3,Devaugntah Williams,SR,G,Texas Tech,Big 12,31,813,111,287,80,182,31,105,76,97,32,66,98,51,25,7,49,55,329
Texas Tech4,4,Keenan Evans,SO,G,Texas Tech,Big 12,31,773,79,191,61,144,18,47,96,126,15,72,87,86,32,10,55,75,272
Texas Tech5,5,Justin Gray,SO,F,Texas Tech,Big 12,30,696,85,163,64,114,21,49,70,89,45,65,110,24,26,17,35,64,261
Texas Tech6,6,Aaron Ross,JR,F,Texas Tech,Big 12,31,669,96,208,65,123,31,85,95,109,29,110,139,26,7,9,35,72,318
Texas Tech7,7,Devon Thomas,JR,G,Texas Tech,Big 12,31,388,30,70,27,55,3,15,13,22,5,34,39,44,14,1,27,32,76
Texas Tech8,8,Norense Odiase,SO,C,Texas Tech,Big 12,19,368,71,139,71,138,0,1,25,40,32,51,83,17,5,14,32,54,167
Texas Tech9,9,Matthew Temple,JR,F,Texas Tech,Big 12,24,302,35,72,32,67,3,5,13,25,18,24,42,16,6,8,19,64,86
Texas Tech10,10,C.J. Williamson,FR,G,Texas Tech,Big 12,21,139,12,41,8,22,4,19,8,14,3,14,17,8,6,1,14,19,36
Texas Tech11,11,Jordan Jackson,FR,G,Texas Tech,Big 12,23,131,12,33,11,23,1,10,1,8,4,13,17,7,2,2,6,9,26
Texas Tech12,12,Isaiah Manderson,SO,C,Texas Tech,Big 12,4,44,5,11,5,10,0,1,2,3,2,5,7,0,0,0,4,3,12
Texas Tech13,13,Donovan Ham,FR,G,Texas Tech,Big 12,6,8,1,1,1,1,0,0,0,0,0,0,0,0,0,0,0,1,2
Texas-Arlington1,1,Erick Neal,SO,G,Texas-Arlington,Sun Belt,32,1002,133,337,68,145,65,192,89,122,30,94,124,197,49,4,81,86,420
Texas-Arlington2,2,Jalen Jones,JR,G,Texas-Arlington,Sun Belt,33,808,144,314,96,185,48,129,77,95,59,103,162,41,26,1,25,71,413
Texas-Arlington3,3,Jorge Bilbao,JR,F,Texas-Arlington,Sun Belt,33,801,85,181,83,173,2,8,54,88,85,146,231,50,24,18,58,105,226
Texas-Arlington4,4,Drew Charles,JR,G,Texas-Arlington,Sun Belt,33,796,92,250,28,83,64,167,48,62,39,63,102,53,26,3,32,85,296
Texas-Arlington5,5,Kaelon Wilson,SO,G,Texas-Arlington,Sun Belt,32,703,109,240,90,168,19,72,81,116,56,104,160,34,35,4,37,61,318
Texas-Arlington6,6,Nathan Hawkins,SO,G,Texas-Arlington,Sun Belt,33,515,45,134,23,52,22,82,10,21,15,52,67,48,16,3,53,46,122
Texas-Arlington7,7,Kennedy Eubanks,SR,F,Texas-Arlington,Sun Belt,31,490,64,155,38,68,26,87,32,53,25,67,92,22,11,10,33,72,186
Texas-Arlington8,8,Kevin Hervey,SO,F,Texas-Arlington,Sun Belt,16,476,102,225,72,132,30,93,56,74,36,120,156,46,11,13,38,27,290
Texas-Arlington9,9,Nick Pallas,FR,F,Texas-Arlington,Sun Belt,33,433,40,96,40,94,0,2,34,55,42,57,99,30,16,15,42,61,114
Texas-Arlington10,10,Faith Pope,JR,F,Texas-Arlington,Sun Belt,32,358,51,109,42,73,9,36,26,39,24,61,85,20,14,13,17,40,137
Texas-Arlington11,11,Mairega Clarke,JR,G,Texas-Arlington,Sun Belt,16,110,17,31,13,23,4,8,10,14,2,7,9,7,8,6,13,11,48
Texas-Arlington12,12,Julian Harris,SO,F,Texas-Arlington,Sun Belt,17,89,9,27,8,21,1,6,1,2,14,11,25,5,2,0,4,14,20
Texas-Arlington13,13,Courtney Austin,SR,G,Texas-Arlington,Sun Belt,13,62,6,16,4,8,2,8,5,8,4,5,9,8,3,0,5,11,19
Texas-Arlington14,14,Brandon Williams,JR,F,Texas-Arlington,Sun Belt,1,16,3,7,2,3,1,4,4,7,2,3,5,0,0,0,0,0,11
Texas-Arlington15,15,Eubanks Kennedy,SR,F,Texas-Arlington,Sun Belt,1,16,3,7,2,5,1,2,0,2,1,3,4,0,0,1,0,1,7
Texas-El Paso1,1,Dominic Artis,JR,G,Texas-El Paso,CUSA,33,1064,138,342,97,218,41,124,77,117,27,141,168,170,40,8,69,72,394
Texas-El Paso2,2,Lee Moore,JR,G,Texas-El Paso,CUSA,33,1053,156,345,108,213,48,132,146,197,50,127,177,116,46,10,70,70,506
Texas-El Paso3,3,Earvin Morris,SR,G,Texas-El Paso,CUSA,32,822,150,326,100,185,50,141,79,118,15,96,111,56,27,11,51,87,429
Texas-El Paso4,4,Omega Harris,SO,G,Texas-El Paso,CUSA,24,746,102,215,54,106,48,109,44,59,13,47,60,55,28,0,44,63,296
Texas-El Paso5,5,Terry Winn,FR,F,Texas-El Paso,CUSA,32,741,121,237,120,236,1,1,78,149,55,149,204,19,16,25,46,108,321
Texas-El Paso6,6,Hooper Vint,SR,C,Texas-El Paso,CUSA,33,715,119,214,114,192,5,22,49,66,43,117,160,22,7,36,54,91,292
Texas-El Paso7,7,Jake Flaggert,SO,F,Texas-El Paso,CUSA,31,427,22,51,2,3,20,48,5,9,1,36,37,18,4,2,11,51,69
Texas-El Paso8,8,Tevin Caldwell,SR,G,Texas-El Paso,CUSA,28,319,29,46,29,45,0,1,20,24,22,38,60,18,13,4,12,37,78
Texas-El Paso9,9,Trey Touchet,FR,G,Texas-El Paso,CUSA,30,298,25,67,15,28,10,39,14,18,2,19,21,23,6,2,15,22,74
Texas-El Paso10,10,Paul Thomas,FR,F,Texas-El Paso,CUSA,22,241,19,39,19,39,0,0,8,15,17,40,57,11,6,7,15,35,46
Texas-El Paso11,11,Brodricks Jones,FR,F,Texas-El Paso,CUSA,16,139,5,20,5,20,0,0,10,16,5,18,23,3,4,10,8,19,20
Texas-El Paso12,12,Christian Romine,FR,F,Texas-El Paso,CUSA,14,50,5,10,5,10,0,0,2,4,2,3,5,0,0,0,8,11,12
Texas-El Paso13,13,Matt Willms,JR,C,Texas-El Paso,CUSA,2,23,2,4,2,4,0,0,2,4,2,4,6,0,0,0,3,3,6
Texas-El Paso14,14,Ivan Venegas,FR,F,Texas-El Paso,CUSA,8,21,1,5,1,5,0,0,3,9,4,6,10,1,0,1,0,2,5
Texas-El Paso15,15,Victor Mbachu,SR,G,Texas-El Paso,CUSA,7,16,2,5,2,4,0,1,2,4,0,1,1,0,0,0,1,1,6
Texas-Rio Grande Valley1,1,Shaquille Hines,SR,F,Texas-Rio Grande Valley,WAC,30,970,158,342,122,241,36,101,64,86,47,119,166,81,28,19,53,82,416
Texas-Rio Grande Valley2,2,Dakota Slaughter,SR,F,Texas-Rio Grande Valley,WAC,30,934,121,273,65,119,56,154,44,59,27,103,130,63,16,14,48,87,342
Texas-Rio Grande Valley3,3,J.J. Thompson,SR,G,Texas-Rio Grande Valley,WAC,28,899,97,248,68,159,29,89,69,106,15,55,70,137,27,2,68,64,292
Texas-Rio Grande Valley4,4,Antonio Green,FR,G,Texas-Rio Grande Valley,WAC,25,838,103,261,44,106,59,155,24,36,11,94,105,75,15,2,48,47,289
Texas-Rio Grande Valley5,5,Dan Kimasa,SO,F,Texas-Rio Grande Valley,WAC,30,787,114,254,113,243,1,11,70,104,67,130,197,31,13,28,52,85,299
Texas-Rio Grande Valley6,6,Everett Osborne,SR,G,Texas-Rio Grande Valley,WAC,29,486,48,138,33,73,15,65,24,33,12,63,75,26,17,4,32,28,135
Texas-Rio Grande Valley7,7,Ot Elmore,SO,G,Texas-Rio Grande Valley,WAC,20,293,16,53,3,12,13,41,8,10,5,24,29,22,6,2,10,17,53
Texas-Rio Grande Valley8,8,Adonis Rwabigwi,SO,F,Texas-Rio Grande Valley,WAC,29,286,26,52,26,51,0,1,20,36,21,45,66,4,7,9,23,56,72
Texas-Rio Grande Valley9,9,Walter Jones,FR,G,Texas-Rio Grande Valley,WAC,20,232,8,31,5,18,3,13,7,15,4,30,34,12,8,4,14,34,26
Texas-Rio Grande Valley10,10,Christopher Ikuenobe,JR,F,Texas-Rio Grande Valley,WAC,27,209,23,44,23,44,0,0,12,22,12,19,31,7,4,7,10,32,58
Texas-Rio Grande Valley11,11,Nick Dixon,JR,G,Texas-Rio Grande Valley,WAC,2,44,2,14,2,11,0,3,5,9,1,6,7,1,2,0,3,3,9
Texas-San Antonio1,1,Ryan Bowie,SR,G,Texas-San Antonio,CUSA,32,1107,188,425,107,224,81,201,118,152,51,161,212,50,27,7,71,88,575
Texas-San Antonio2,2,J.R. Harris,JR,G,Texas-San Antonio,CUSA,31,873,118,337,52,139,66,198,68,82,12,65,77,49,27,4,58,79,370
Texas-San Antonio3,3,Christian Wilson,SO,G,Texas-San Antonio,CUSA,23,732,121,314,107,246,14,68,130,178,12,82,94,105,38,4,63,49,386
Texas-San Antonio4,4,Lucas O'Brien,JR,F,Texas-San Antonio,CUSA,31,700,89,200,75,145,14,55,33,43,37,75,112,20,20,15,27,95,225
Texas-San Antonio5,5,Austin Karrer,SO,G,Texas-San Antonio,CUSA,32,547,18,49,15,26,3,23,13,31,20,36,56,25,21,7,26,69,52
Texas-San Antonio6,6,Gino Littles,SO,G,Texas-San Antonio,CUSA,17,503,47,93,40,78,7,15,30,47,7,44,51,53,20,0,35,26,131
Texas-San Antonio7,7,Nick Allen,FR,F,Texas-San Antonio,CUSA,31,501,50,110,43,84,7,26,20,31,22,69,91,24,12,10,45,84,127
Texas-San Antonio8,8,A.J. Cockrell,FR,F,Texas-San Antonio,CUSA,32,421,42,90,42,89,0,1,23,40,33,36,69,8,8,8,19,74,107
Texas-San Antonio9,9,Phillip Jones,JR,F,Texas-San Antonio,CUSA,20,314,36,84,36,80,0,4,28,54,40,47,87,10,13,7,22,44,100
Texas-San Antonio10,10,James Ringholt,SO,F,Texas-San Antonio,CUSA,25,284,14,39,5,6,9,33,9,12,5,34,39,8,2,9,8,22,46
Texas-San Antonio11,11,Nick Billingsley,JR,G,Texas-San Antonio,CUSA,23,244,39,94,32,66,7,28,23,32,9,30,39,5,8,3,22,36,108
Texas-San Antonio12,12,George Matthews,SR,G,Texas-San Antonio,CUSA,10,116,26,58,16,29,10,29,5,5,12,22,34,4,6,6,16,19,67
Texas-San Antonio13,13,Terrell Scruggs,JR,F,Texas-San Antonio,CUSA,15,82,4,14,4,10,0,4,4,10,4,10,14,3,4,0,11,12,12
Texas-San Antonio14,14,Kyle Massie,FR,G,Texas-San Antonio,CUSA,8,26,4,8,2,2,2,6,1,2,1,1,2,2,0,0,1,4,11
Toledo1,1,Nathan Boothe,SR,C,Toledo,MAC,32,1007,241,486,208,398,33,88,103,125,60,227,287,105,21,33,71,83,618
Toledo2,2,Jonathan Williams,JR,G,Toledo,MAC,32,988,207,454,137,268,70,186,80,115,18,77,95,91,26,2,89,62,564
Toledo3,3,Stuckey Mosley,SO,G,Toledo,MAC,32,975,112,265,78,171,34,94,69,88,14,139,153,126,37,5,65,80,327
Toledo4,4,Jaelan Sanford,FR,G,Toledo,MAC,32,879,83,194,35,58,48,136,48,59,14,51,65,59,22,7,33,58,262
Toledo5,5,Jordan Lauf,JR,G,Toledo,MAC,32,774,47,91,37,59,10,32,43,62,61,60,121,42,23,3,18,67,147
Toledo6,6,Nate Navigato,FR,F,Toledo,MAC,32,731,84,209,23,50,61,159,40,48,20,90,110,42,22,6,32,66,269
Toledo7,7,Zach Garber,JR,C,Toledo,MAC,32,586,59,95,59,94,0,1,73,104,55,100,155,18,9,6,26,69,191
Toledo8,8,Nick Rogers,FR,G,Toledo,MAC,31,282,15,55,8,29,7,26,30,44,2,22,24,36,7,1,14,41,67
Toledo9,9,Taylor Adway,FR,F,Toledo,MAC,17,130,12,20,12,20,0,0,1,7,7,19,26,4,0,0,12,16,25
Toledo10,10,Chandler White,FR,G,Toledo,MAC,8,28,3,8,3,8,0,0,0,0,2,5,7,0,0,0,6,8,6
Toledo11,11,Fred John Jr.,FR,F,Toledo,MAC,8,20,2,4,2,4,0,0,2,3,3,5,8,0,0,0,1,2,6
Towson1,1,Mike Morsell,SO,F,Towson,CAA,32,969,136,355,98,230,38,125,97,131,43,91,134,80,33,18,69,91,407
Towson2,2,Byron Hawkins,SO,G,Towson,CAA,30,913,124,313,68,136,56,177,98,126,12,64,76,67,23,7,33,58,402
Towson3,3,Arnaud William Adala Moto,JR,F,Towson,CAA,32,902,142,321,125,266,17,55,143,198,72,189,261,49,25,4,94,87,444
Towson4,4,Timajh Parker-Rivera,SR,F,Towson,CAA,32,816,78,135,78,134,0,1,58,115,93,118,211,37,30,38,44,88,214
Towson5,5,John Davis,JR,F,Towson,CAA,32,810,125,267,100,203,25,64,55,81,60,117,177,23,19,12,39,77,330
Towson6,6,Eddie Keith,SO,F,Towson,CAA,31,697,51,136,36,91,15,45,36,59,25,62,87,51,31,16,30,87,153
Towson7,7,Walter Foster,JR,F,Towson,CAA,28,613,59,139,59,139,0,0,43,60,66,71,137,12,14,41,36,65,161
Towson8,8,Jordan McNeil,FR,G,Towson,CAA,32,313,34,87,18,38,16,49,12,21,12,16,28,23,11,1,23,31,96
Towson9,9,Josh Ivory,SR,G,Towson,CAA,30,232,12,41,1,4,11,37,1,4,0,8,8,19,5,0,11,25,36
Towson10,10,Alex Thomas,FR,F,Towson,CAA,28,178,16,29,16,29,0,0,7,13,25,18,43,0,8,13,3,40,39
Towson11,11,Mike Davis,JR,F,Towson,CAA,4,7,2,2,2,2,0,0,0,2,0,1,1,0,0,0,2,2,4
Troy1,1,Wesley Person,SO,G,Troy,Sun Belt,31,1089,171,403,75,146,96,257,83,109,17,92,109,46,7,5,38,42,521
Troy2,2,John Walton,SR,F,Troy,Sun Belt,31,909,115,257,114,254,1,3,117,169,87,170,257,26,20,20,59,93,348
Troy3,3,Jordon Varnado,FR,F,Troy,Sun Belt,31,878,159,328,131,240,28,88,63,99,72,143,215,29,18,37,34,78,409
Troy4,4,Jeremy Hollimon,JR,G,Troy,Sun Belt,31,836,102,304,66,176,36,128,80,117,23,74,97,51,32,3,64,72,320
Troy5,5,Daniel Peace,JR,G,Troy,Sun Belt,31,762,50,130,50,126,0,4,39,89,6,50,56,97,44,1,71,102,139
Troy6,6,B.J. Miller,FR,G,Troy,Sun Belt,31,529,45,105,36,63,9,42,18,26,15,48,63,54,21,3,45,44,117
Troy7,7,Shawn Hopkins,FR,G,Troy,Sun Belt,29,403,32,104,11,30,21,74,20,36,16,50,66,12,7,4,19,33,105
Troy8,8,Jaro Moravek,SO,F,Troy,Sun Belt,30,332,23,70,10,21,13,49,11,17,22,35,57,10,12,9,11,36,70
Troy9,9,Kelton Ford,JR,G,Troy,Sun Belt,22,235,20,63,16,38,4,25,16,28,4,20,24,20,16,1,16,33,60
Troy10,10,Aaron Ariri,SO,F,Troy,Sun Belt,26,202,20,36,20,36,0,0,7,15,20,34,54,1,4,3,5,35,47
Troy11,11,Damion Ottman,FR,F,Troy,Sun Belt,14,61,1,12,1,7,0,5,3,6,0,15,15,2,1,2,5,11,5
Troy12,12,Jordan Howard,JR,G,Troy,Sun Belt,6,6,2,5,2,5,0,0,0,2,1,2,3,1,0,0,4,1,4
Tulane1,1,Dylan Osetkowski,SO,F,Tulane,AAC,34,1100,141,322,129,277,12,45,89,131,90,192,282,53,41,18,76,76,383
Tulane2,2,Louis Dabney,SR,G,Tulane,AAC,33,1088,153,413,99,240,54,173,114,144,26,74,100,73,35,4,68,86,474
Tulane3,3,Malik Morgan,SR,G,Tulane,AAC,34,1075,154,365,91,185,63,180,44,69,37,137,174,80,47,14,84,82,415
Tulane4,4,Melvin Frazier,FR,G,Tulane,AAC,34,662,63,157,45,94,18,63,32,62,41,66,107,24,31,9,38,49,176
Tulane5,5,Cameron Reynolds,JR,G,Tulane,AAC,30,617,73,209,49,119,24,90,28,34,29,73,102,17,18,7,38,66,198
Tulane6,6,Von Julien,FR,G,Tulane,AAC,31,588,37,104,24,56,13,48,9,13,5,36,41,67,16,0,33,49,96
Tulane7,7,Kain Harris,FR,G,Tulane,AAC,33,523,51,162,27,78,24,84,36,45,7,41,48,12,4,4,22,54,162
Tulane8,8,Jernard Jarreau,SR,F,Tulane,AAC,18,402,51,113,45,95,6,18,29,52,26,74,100,28,10,31,36,39,137
Tulane9,9,Blake Paul,FR,F,Tulane,AAC,33,368,29,53,29,53,0,0,17,30,35,46,81,2,5,30,20,71,75
Tulane10,10,Ryan Smith,JR,C,Tulane,AAC,33,359,30,61,30,61,0,0,20,33,43,32,75,7,8,13,12,55,80
Tulane11,11,T.J. Oliver,FR,F,Tulane,AAC,17,101,16,41,14,32,2,9,2,5,15,18,33,2,0,1,9,16,36
Tulane12,12,Kajon Mack,JR,G,Tulane,AAC,5,51,4,15,4,12,0,3,0,3,0,9,9,7,3,0,3,4,8
Tulsa1,1,James Woodard,SR,G,Tulsa,AAC,30,1021,142,337,66,128,76,209,108,138,19,136,155,73,31,12,56,49,468
Tulsa2,2,Shaquille Harrison,SR,G,Tulsa,AAC,31,1003,164,354,157,314,7,40,125,195,31,139,170,127,59,6,65,65,460
Tulsa3,3,Pat Birt,JR,G,Tulsa,AAC,31,820,120,316,42,105,78,211,65,88,18,86,104,25,20,4,32,69,383
Tulsa4,4,Marquel Curtis,SR,G,Tulsa,AAC,30,741,70,162,55,111,15,51,47,70,43,83,126,65,23,6,40,52,202
Tulsa5,5,Brandon Swannegan,SR,F,Tulsa,AAC,31,618,76,132,76,132,0,0,51,84,53,67,120,8,14,27,23,75,203
Tulsa6,6,Rashad Smith,SR,G,Tulsa,AAC,29,610,89,169,85,153,4,16,27,48,50,73,123,35,21,18,39,62,209
Tulsa7,7,D'Andre Wright,SR,F,Tulsa,AAC,31,549,62,128,62,119,0,9,37,53,36,69,105,10,6,9,32,95,161
Tulsa8,8,Rashad Ray,SR,G,Tulsa,AAC,31,545,45,126,21,52,24,74,15,25,9,35,44,59,30,0,21,51,129
Tulsa9,9,Sterling Taplin,FR,G,Tulsa,AAC,28,280,26,64,14,20,12,44,11,14,1,30,31,21,6,1,16,24,75
Tulsa10,10,Nick Wood,SR,G,Tulsa,AAC,5,8,2,4,2,3,0,1,0,0,1,0,1,0,0,0,0,0,4
UC-Davis1,1,Darius Graham,JR,G,UC-Davis,Big West,30,1000,96,241,48,113,48,128,60,85,11,57,68,82,24,3,88,56,300
UC-Davis2,2,Brynton Lemar,JR,G,UC-Davis,Big West,30,929,108,269,59,149,49,120,41,59,14,93,107,47,24,1,50,76,306
UC-Davis3,3,Siler Schneider,FR,G,UC-Davis,Big West,30,892,106,267,69,170,37,97,41,62,11,82,93,70,24,2,85,98,290
UC-Davis4,4,Josh Fox,SR,F,UC-Davis,Big West,28,886,164,320,164,319,0,1,86,130,55,134,189,58,31,12,72,69,414
UC-Davis5,5,Neal Monson,JR,C,UC-Davis,Big West,29,841,101,205,101,202,0,3,59,87,63,183,246,24,13,12,42,63,261
UC-Davis6,6,Lawrence White,JR,G,UC-Davis,Big West,28,635,58,130,47,87,11,43,23,55,16,70,86,33,38,6,33,72,150
UC-Davis7,7,Garrison Goode,FR,F,UC-Davis,Big West,29,441,18,51,18,50,0,1,10,27,25,36,61,12,14,6,21,44,46
UC-Davis8,8,Rogers Printup,FR,G,UC-Davis,Big West,22,198,8,36,0,2,8,34,0,0,2,21,23,4,5,3,3,14,24
UC-Davis9,9,Nolan Berry,SO,C,UC-Davis,Big West,10,175,26,55,17,36,9,19,31,39,4,36,40,6,8,2,14,25,92
UC-Davis10,10,Georgi Funtarov,JR,F,UC-Davis,Big West,10,94,11,28,9,13,2,15,3,10,6,21,27,3,4,1,7,8,27
UC-Davis11,11,Michael Onyebalu,SO,G,UC-Davis,Big West,12,34,1,6,1,4,0,2,2,3,1,3,4,3,1,1,3,6,4
UC-Irvine1,1,Luke Nelson,JR,G,UC-Irvine,Big West,34,1042,157,357,85,157,72,200,82,95,12,89,101,135,40,4,57,54,468
UC-Irvine2,2,Alex Young,SR,G,UC-Irvine,Big West,33,981,117,283,85,196,32,87,62,84,22,110,132,149,48,9,46,78,328
UC-Irvine3,3,Mamadou Ndiaye,JR,C,UC-Irvine,Big West,34,801,157,236,157,236,0,0,108,170,70,176,246,22,5,84,78,90,422
UC-Irvine4,4,Mike Best,SR,F,UC-Irvine,Big West,34,758,130,275,130,273,0,2,59,74,46,123,169,23,7,18,50,74,319
UC-Irvine5,5,Jaron Martin,JR,G,UC-Irvine,Big West,34,669,92,237,37,101,55,136,42,55,12,39,51,50,21,0,34,45,281
UC-Irvine6,6,Aaron Wright,SR,G,UC-Irvine,Big West,31,620,32,90,19,50,13,40,37,60,12,81,93,60,24,1,40,79,114
UC-Irvine7,7,Dominique Dunning,SR,G,UC-Irvine,Big West,31,521,32,80,25,64,7,16,25,45,19,64,83,36,19,1,20,43,96
UC-Irvine8,8,Ioannis Dimakopoulos,JR,C,UC-Irvine,Big West,34,484,71,151,61,123,10,28,25,39,20,71,91,22,6,31,28,58,177
UC-Irvine9,9,Jonathan Galloway,FR,F,UC-Irvine,Big West,34,471,36,61,36,61,0,0,21,43,42,72,114,7,7,20,26,59,93
UC-Irvine10,10,Brandon Smith,FR,F,UC-Irvine,Big West,32,337,21,53,13,30,8,23,12,20,17,36,53,11,8,6,20,34,62
UC-Irvine11,11,Haroldas Saprykinas,SO,G,UC-Irvine,Big West,27,111,15,39,3,8,12,31,5,9,7,9,16,2,2,0,5,6,47
UC-Irvine12,12,Shawn Ray,SR,F,UC-Irvine,Big West,15,39,1,8,1,8,0,0,0,1,4,2,6,0,0,5,1,4,2
UC-Irvine13,13,Spencer Rivers,FR,G,UC-Irvine,Big West,9,16,2,6,0,0,2,6,2,7,0,2,2,1,2,0,3,2,8
UC-Riverside1,1,Jaylen Bland,SR,G,UC-Riverside,Big West,33,1120,165,421,48,130,117,291,81,98,15,109,124,59,47,5,74,69,528
UC-Riverside2,2,Secean Johnson,JR,F,UC-Riverside,Big West,33,941,123,297,95,210,28,87,124,165,49,142,191,65,29,7,81,97,398
UC-Riverside3,3,Malik Thames,JR,G,UC-Riverside,Big West,31,815,66,171,39,98,27,73,54,69,9,69,78,91,24,6,35,49,213
UC-Riverside4,4,Alex Larsson,SO,F,UC-Riverside,Big West,33,676,67,133,67,133,0,0,29,65,56,75,131,10,4,19,36,116,163
UC-Riverside5,5,Taylor Johns,SR,F,UC-Riverside,Big West,22,673,118,247,106,202,12,45,96,139,49,116,165,46,16,32,71,63,344
UC-Riverside6,6,Gentrey Thomas,JR,G,UC-Riverside,Big West,29,646,81,182,63,112,18,70,26,38,31,81,112,45,17,3,49,52,206
UC-Riverside7,7,Steven Jones,SR,G,UC-Riverside,Big West,31,507,32,92,22,55,10,37,7,20,10,41,51,43,12,1,18,72,81
UC-Riverside8,8,Menno Dijkstra,FR,C,UC-Riverside,Big West,33,469,67,111,67,111,0,0,12,13,41,61,102,12,5,18,15,49,146
UC-Riverside9,9,Robert Boezeman,SO,F,UC-Riverside,Big West,28,338,30,79,10,23,20,56,8,16,10,44,54,9,6,7,17,46,88
UC-Riverside10,10,DJ Sylvester,FR,G,UC-Riverside,Big West,23,230,24,54,10,17,14,37,17,24,5,22,27,19,4,3,11,22,79
UC-Riverside11,11,Primitivo Gomez,JR,F,UC-Riverside,Big West,12,101,6,23,3,16,3,7,11,14,7,13,20,3,2,0,9,5,26
UC-Riverside12,12,Eric Rwahwire,FR,F,UC-Riverside,Big West,11,71,6,24,4,13,2,11,5,7,1,10,11,6,0,0,6,11,19
UC-Riverside13,13,Koh Flippin,FR,G,UC-Riverside,Big West,4,14,3,5,2,3,1,2,1,2,0,1,1,2,4,0,3,3,8
UC-Santa Barbara1,1,Michael Bryson,SR,G,UC-Santa Barbara,Big West,30,1008,193,400,127,229,66,171,99,118,47,146,193,75,25,19,69,70,551
UC-Santa Barbara2,2,Gabe Vincent,SO,G,UC-Santa Barbara,Big West,31,986,153,371,80,182,73,189,53,65,20,79,99,69,39,6,55,87,432
UC-Santa Barbara3,3,Eric Childress,JR,G,UC-Santa Barbara,Big West,31,828,77,176,46,109,31,67,25,31,17,102,119,136,41,4,64,70,210
UC-Santa Barbara4,4,Sam Beeler,SR,F,UC-Santa Barbara,Big West,31,583,93,131,93,131,0,0,17,44,46,99,145,18,6,23,30,94,203
UC-Santa Barbara5,5,John Green,SR,G,UC-Santa Barbara,Big West,25,580,91,232,65,158,26,74,62,90,28,99,127,37,24,4,41,69,270
UC-Santa Barbara6,6,Mitch Brewe,SR,F,UC-Santa Barbara,Big West,31,493,61,124,60,112,1,12,41,55,42,52,94,20,18,9,17,64,164
UC-Santa Barbara7,7,Maxwell Kupchak,FR,F,UC-Santa Barbara,Big West,31,477,42,109,35,82,7,27,29,41,8,72,80,29,5,8,29,56,120
UC-Santa Barbara8,8,T.J. Taylor,SR,G,UC-Santa Barbara,Big West,31,415,26,79,10,32,16,47,0,1,4,20,24,51,6,0,25,28,68
UC-Santa Barbara9,9,DaJuan Smith,SR,G,UC-Santa Barbara,Big West,30,325,30,75,28,67,2,8,10,17,20,39,59,18,12,1,16,18,72
UC-Santa Barbara10,10,Jarriesse Blackmon,FR,F,UC-Santa Barbara,Big West,22,189,13,49,11,40,2,9,5,8,16,36,52,8,5,7,5,12,33
UC-Santa Barbara11,11,Alex Hart,SO,F,UC-Santa Barbara,Big West,25,178,28,61,20,38,8,23,6,14,15,32,47,6,3,7,14,16,70
UC-Santa Barbara12,12,Ami Lakoju,FR,F,UC-Santa Barbara,Big West,15,70,4,10,4,10,0,0,0,4,5,8,13,0,1,7,8,21,8
UC-Santa Barbara13,13,Grant Troutt,FR,G,UC-Santa Barbara,Big West,11,46,4,12,1,3,3,9,0,0,2,0,2,4,2,0,3,2,11
UC-Santa Barbara14,14,Justin Burks,FR,F,UC-Santa Barbara,Big West,4,23,1,4,0,1,1,3,0,0,1,2,3,1,0,0,1,3,3
UCLA1,1,Bryce Alford,JR,G,UCLA,Pac-12,32,1159,157,408,84,209,73,199,128,154,9,113,122,167,23,0,63,41,515
UCLA2,2,Isaac Hamilton,JR,G,UCLA,Pac-12,32,1129,206,436,146,277,60,159,66,82,31,104,135,106,33,2,76,69,538
UCLA3,3,Aaron Holiday,FR,G,UCLA,Pac-12,32,1013,114,289,75,196,39,93,64,88,19,77,96,127,45,8,92,103,331
UCLA4,4,Thomas Welsh,SO,C,UCLA,Pac-12,31,832,157,266,157,266,0,0,34,45,100,163,263,17,8,32,25,86,348
UCLA5,5,Tony Parker,SR,F,UCLA,Pac-12,32,802,164,304,164,304,0,0,74,150,104,158,262,21,20,31,54,103,402
UCLA6,6,Jonah Bolden,SO,G,UCLA,Pac-12,31,672,51,123,42,87,9,36,33,45,36,114,150,33,21,27,26,64,144
UCLA7,7,Prince Ali,FR,G,UCLA,Pac-12,29,342,40,103,28,63,12,40,21,37,5,26,31,11,11,3,23,36,113
UCLA8,8,Gyorgy Goloman,SO,F,UCLA,Pac-12,15,181,11,33,9,24,2,9,6,16,18,23,41,4,5,6,10,34,30
UCLA9,9,Alex Olesinski,FR,F,UCLA,Pac-12,23,161,7,26,6,19,1,7,13,20,21,25,46,4,5,0,10,34,28
UCLA10,10,Noah Allen,JR,G,UCLA,Pac-12,24,154,6,22,4,17,2,5,11,14,3,14,17,10,4,1,5,21,25
UCLA11,11,Alec Wulff,SO,G,UCLA,Pac-12,5,7,2,2,0,0,2,2,0,0,0,0,0,1,0,0,0,0,6
University of California1,1,Jordan Mathews,JR,G,University of California,Pac-12,33,980,134,323,48,117,86,206,81,102,24,86,110,41,15,0,44,70,435
University of California2,2,Ivan Rabb,FR,F,University of California,Pac-12,33,937,156,251,155,250,1,1,100,150,91,187,278,29,18,41,51,102,413
University of California3,3,Jaylen Brown,FR,F,University of California,Pac-12,33,922,162,372,132,272,30,100,140,215,35,145,180,68,27,22,98,103,494
University of California4,4,Tyrone Wallace,SR,G,University of California,Pac-12,28,901,151,342,126,258,25,84,100,154,27,121,148,123,27,12,74,63,427
University of California5,5,Jabari Bird,JR,G,University of California,Pac-12,33,883,125,270,64,121,61,149,31,46,25,85,110,31,17,11,27,56,342
University of California6,6,Sam Singer,JR,G,University of California,Pac-12,33,648,44,113,34,77,10,36,17,28,15,65,80,88,15,2,45,64,115
University of California7,7,Kameron Rooks,SO,C,University of California,Pac-12,32,544,45,77,45,77,0,0,22,40,61,95,156,12,5,27,17,94,112
University of California8,8,Kingsley Okoroh,SO,C,University of California,Pac-12,30,321,19,32,19,32,0,0,5,14,16,41,57,6,4,33,18,61,43
University of California9,9,Stephen Domingo,JR,G,University of California,Pac-12,29,305,18,52,7,18,11,34,3,11,19,32,51,17,5,8,9,28,50
University of California10,10,Roger Moute a Bidias,JR,F,University of California,Pac-12,22,161,7,20,2,12,5,8,6,6,3,17,20,4,1,2,4,34,25
University of California11,11,Brandon Chauca,SO,G,University of California,Pac-12,8,30,1,7,0,1,1,6,2,2,0,0,0,4,1,0,3,3,5
University of California12,12,Brenden Glapion,SR,G,University of California,Pac-12,8,17,1,7,1,5,0,2,4,6,0,1,1,1,0,0,2,2,6
University of California13,13,Cole Welle,SO,F,University of California,Pac-12,5,13,1,3,1,3,0,0,1,6,0,4,4,0,1,0,0,1,3
University of California14,14,Nick Kerr,SR,G,University of California,Pac-12,7,11,3,6,0,0,3,6,0,0,0,1,1,0,0,0,0,1,9
Utah1,1,Brandon Taylor,SR,G,Utah,Pac-12,34,1121,108,273,46,93,62,180,48,60,8,74,82,130,53,1,75,46,326
Utah2,2,Jordan Loveridge,SR,F,Utah,Pac-12,34,1045,121,307,35,93,86,214,72,92,14,120,134,59,18,5,38,72,400
Utah3,3,Jakob Poeltl,SO,F,Utah,Pac-12,34,1033,221,337,221,337,0,0,157,227,93,212,305,64,20,55,68,80,599
Utah4,4,Lorenzo Bonam,JR,G,Utah,Pac-12,34,892,126,249,105,196,21,53,64,79,19,90,109,104,34,18,53,57,337
Utah5,5,Kyle Kuzma,SO,F,Utah,Pac-12,34,812,146,282,136,236,10,46,64,106,63,139,202,50,12,14,64,69,366
Utah6,6,Dakarai Tucker,SR,F,Utah,Pac-12,34,628,60,136,17,32,43,104,19,26,12,70,82,25,14,16,25,42,182
Utah7,7,Brekkott Chapman,SO,F,Utah,Pac-12,34,459,53,123,43,86,10,37,34,53,37,61,98,35,13,20,27,67,150
Utah8,8,Isaiah Wright,SO,G,Utah,Pac-12,27,363,19,50,8,17,11,33,9,13,0,29,29,43,6,4,24,32,58
Utah9,9,Chris Reyes,JR,F,Utah,Pac-12,33,282,29,55,29,51,0,4,30,43,24,50,74,7,6,7,19,27,88
Utah10,10,Gabe Bealer,JR,F,Utah,Pac-12,14,103,20,41,14,23,6,18,13,19,8,11,19,3,2,3,2,12,59
Utah11,11,Kenneth Ogbe,JR,G,Utah,Pac-12,5,62,7,17,2,5,5,12,7,8,0,5,5,1,3,0,1,8,26
Utah12,12,Austin Montgomery,FR,F,Utah,Pac-12,8,36,10,13,9,12,1,1,5,6,5,7,12,2,0,1,4,5,26
Utah13,13,Austin Eastman,SR,G,Utah,Pac-12,10,31,1,6,0,0,1,6,2,2,1,5,6,5,1,1,2,2,5
Utah14,14,Jake Connor,FR,G,Utah,Pac-12,6,28,7,9,4,4,3,5,0,0,0,1,1,4,1,0,1,4,17
Utah State1,1,Jalen Moore,JR,F,Utah State,MWC,31,1060,167,375,117,230,50,145,78,110,42,137,179,80,25,18,47,52,462
Utah State2,2,Chris Smith,SR,G,Utah State,MWC,31,960,161,326,98,186,63,140,79,106,43,120,163,64,25,12,50,66,464
Utah State3,3,Darius Perkins,SR,G,Utah State,MWC,31,761,73,176,29,66,44,110,18,22,3,65,68,56,16,2,39,45,208
Utah State4,4,Shane Rector,JR,G,Utah State,MWC,31,731,101,233,81,173,20,60,65,86,12,66,78,101,38,5,73,67,287
Utah State5,5,Julion Pearre,SO,G,Utah State,MWC,31,716,91,214,50,94,41,120,25,40,7,46,53,45,18,6,34,68,248
Utah State6,6,Lew Evans,JR,F,Utah State,MWC,30,642,77,187,51,114,26,73,72,101,57,112,169,27,11,5,53,78,252
Utah State7,7,Elston Jones,SO,F,Utah State,MWC,31,457,51,100,51,100,0,0,29,56,55,61,116,18,15,20,34,77,131
Utah State8,8,Quinn Taylor,FR,F,Utah State,MWC,30,439,51,80,47,74,4,6,19,33,36,75,111,26,10,4,15,62,125
Utah State9,9,Grayson Moore,SR,F,Utah State,MWC,18,283,20,60,13,30,7,30,17,24,25,44,69,23,8,8,14,20,64
Utah State10,10,Henry Bolton,SO,G,Utah State,MWC,9,58,3,4,3,3,0,1,3,4,0,5,5,10,2,1,2,3,9
Utah State11,11,John Middleton,FR,G,Utah State,MWC,8,49,4,13,3,9,1,4,5,8,1,3,4,0,2,0,1,5,14
Utah State12,12,Trace Cureton,SR,F,Utah State,MWC,9,44,3,11,2,5,1,6,3,7,1,5,6,4,1,0,3,3,10
Utah Valley1,1,Jaden Jackson,SR,G,Utah Valley,WAC,30,1006,154,371,94,211,60,160,63,77,16,59,75,74,26,1,35,42,431
Utah Valley2,2,Marcel Davis,SR,G,Utah Valley,WAC,30,1001,146,329,106,218,40,111,96,134,27,140,167,153,33,5,82,65,428
Utah Valley3,3,Konner Frey,JR,F,Utah Valley,WAC,30,825,141,334,96,199,45,135,97,134,59,153,212,36,18,11,69,78,424
Utah Valley4,4,Ivory Young,JR,G,Utah Valley,WAC,26,696,83,238,34,108,49,130,18,25,7,56,63,52,26,0,50,45,233
Utah Valley5,5,Hayden Schenck,FR,G,Utah Valley,WAC,26,558,45,108,30,58,15,50,62,74,21,84,105,47,25,10,50,87,167
Utah Valley6,6,Dayon Goodman,SO,F,Utah Valley,WAC,30,515,69,114,69,110,0,4,51,76,43,70,113,15,11,14,28,75,189
Utah Valley7,7,Andrew Bastien,JR,C,Utah Valley,WAC,26,349,28,63,28,63,0,0,24,40,39,71,110,6,5,33,18,65,80
Utah Valley8,8,Cory Cardwell,SR,G,Utah Valley,WAC,27,319,30,79,7,14,23,65,9,11,2,28,30,26,9,2,9,34,92
Utah Valley9,9,Alex Carr,SR,G,Utah Valley,WAC,28,296,15,50,3,12,12,38,1,5,4,56,60,9,12,2,18,55,43
Utah Valley10,10,Darrious Hamilton,SR,F,Utah Valley,WAC,25,288,50,83,50,83,0,0,22,34,21,36,57,2,6,14,19,56,122
Utah Valley11,11,Telly Davenport,FR,G,Utah Valley,WAC,4,76,8,17,7,11,1,6,4,7,0,16,16,10,2,2,11,9,21
Utah Valley12,12,Tyler Ott,SO,F,Utah Valley,WAC,13,66,9,26,3,7,6,19,4,7,0,9,9,1,2,0,5,14,28
Utah Valley13,13,Hayes Garrity,JR,G,Utah Valley,WAC,3,50,7,19,2,9,5,10,3,4,0,3,3,4,1,1,1,2,22
Valparaiso1,1,Alec Peters,JR,F,Valparaiso,Horizon,32,999,187,374,107,196,80,178,121,141,86,183,269,34,23,9,53,65,575
Valparaiso2,2,Keith Carter,SR,G,Valparaiso,Horizon,31,876,105,251,51,115,54,136,44,73,17,84,101,137,50,7,45,71,308
Valparaiso3,3,Vashil Fernandez,SR,C,Valparaiso,Horizon,31,780,74,149,74,149,0,0,28,59,87,142,229,16,15,96,41,95,176
Valparaiso4,4,Tevonn Walker,SO,G,Valparaiso,Horizon,27,637,91,226,64,141,27,85,50,77,25,70,95,48,24,3,36,70,259
Valparaiso5,5,Shane Hammink,JR,G,Valparaiso,Horizon,30,628,96,185,78,127,18,58,54,66,18,74,92,48,20,4,63,64,264
Valparaiso6,6,Darien Walker,SR,G,Valparaiso,Horizon,31,624,88,228,52,125,36,103,37,49,28,95,123,30,20,3,36,49,249
Valparaiso7,7,Jubril Adekoya,JR,F,Valparaiso,Horizon,32,606,73,144,58,117,15,27,45,58,39,96,135,28,24,11,42,74,206
Valparaiso8,8,David Skara,SO,F,Valparaiso,Horizon,24,487,57,128,40,74,17,54,32,43,29,45,74,39,10,8,29,53,163
Valparaiso9,9,E. Victor Nickerson,SR,G,Valparaiso,Horizon,27,429,36,121,30,83,6,38,51,73,15,49,64,33,15,2,44,53,129
Valparaiso10,10,Max Joseph,SO,G,Valparaiso,Horizon,21,176,9,34,7,20,2,14,15,23,8,15,23,17,12,0,10,18,35
Valparaiso11,11,Lexus Williams,SO,G,Valparaiso,Horizon,13,91,9,28,6,11,3,17,3,5,3,8,11,6,6,0,4,10,24
Valparaiso12,12,Nick Davidson,JR,G,Valparaiso,Horizon,12,76,7,18,5,10,2,8,13,14,1,4,5,6,3,0,1,6,29
Valparaiso13,13,Chandler Levingston Simon,SO,F,Valparaiso,Horizon,10,41,4,6,4,6,0,0,0,0,5,7,12,2,0,0,1,11,8
Vanderbilt1,1,Wade Baldwin,SO,G,Vanderbilt,SEC,32,969,132,307,91,208,41,99,152,191,13,115,128,167,39,11,87,81,457
Vanderbilt2,2,Matthew Fisher-Davis,SO,G,Vanderbilt,SEC,31,859,102,231,23,58,79,173,25,33,12,101,113,36,15,9,26,48,308
Vanderbilt3,3,Damian Jones,JR,C,Vanderbilt,SEC,32,840,182,306,182,303,0,3,89,161,72,150,222,38,8,52,65,104,453
Vanderbilt4,4,Jeff Roberson,SO,F,Vanderbilt,SEC,31,830,90,179,60,113,30,66,84,100,56,117,173,37,15,6,33,98,294
Vanderbilt5,5,Riley LaChance,SO,G,Vanderbilt,SEC,32,797,76,218,34,102,42,116,25,33,11,66,77,79,20,1,43,58,219
Vanderbilt6,6,Luke Kornet,JR,F,Vanderbilt,SEC,27,735,84,206,59,118,25,88,48,69,49,146,195,41,14,82,31,67,241
Vanderbilt7,7,Nolan Cressler,JR,G,Vanderbilt,SEC,29,364,57,124,40,62,17,62,12,23,9,55,64,23,3,2,21,41,143
Vanderbilt8,8,Josh Henderson,SR,C,Vanderbilt,SEC,31,321,40,79,38,76,2,3,28,45,20,47,67,17,6,12,20,38,110
Vanderbilt9,9,Camron Justice,FR,G,Vanderbilt,SEC,25,254,31,75,10,21,21,54,5,6,2,25,27,9,9,0,14,28,88
Vanderbilt10,10,Joe Toye,FR,G,Vanderbilt,SEC,29,231,34,68,26,49,8,19,22,35,6,28,34,10,6,2,12,25,98
Vanderbilt11,11,Samir Sehic,FR,F,Vanderbilt,SEC,22,104,7,21,4,15,3,6,9,14,12,19,31,4,1,0,2,11,26
Vanderbilt12,12,Carter Josephs,SR,G,Vanderbilt,SEC,21,98,1,1,1,1,0,0,2,5,1,6,7,16,2,0,7,6,4
Vanderbilt13,13,Nathan Watkins,SR,G,Vanderbilt,SEC,11,29,2,2,2,2,0,0,0,2,1,4,5,1,0,0,0,3,4
Vanderbilt14,14,Phillip McGloin,SO,G,Vanderbilt,SEC,10,18,3,9,1,3,2,6,3,4,0,4,4,0,0,0,0,2,11
Vermont1,1,Kurt Steidl,JR,F,Vermont,AEC,33,970,114,253,50,82,64,171,66,83,18,153,171,34,32,12,38,80,358
Vermont2,2,Ethan O'Day,SR,F,Vermont,AEC,34,967,167,302,167,301,0,1,66,109,60,154,214,43,21,69,62,105,400
Vermont3,3,Trae Bell-Haynes,SO,G,Vermont,AEC,33,905,121,251,97,194,24,57,122,157,14,67,81,115,39,2,89,79,388
Vermont4,4,Ernie Duncan,FR,G,Vermont,AEC,31,863,111,251,34,79,77,172,47,56,13,78,91,84,24,1,63,62,346
Vermont5,5,Cam Ward,SO,G,Vermont,AEC,34,822,108,245,59,108,49,137,59,74,10,76,86,80,20,0,42,65,324
Vermont6,6,Darren Payen,JR,F,Vermont,AEC,34,636,99,184,99,184,0,0,32,56,47,97,144,9,8,28,40,83,230
Vermont7,7,Dre Wills,JR,G,Vermont,AEC,21,483,69,123,68,119,1,4,34,62,25,73,98,49,22,10,47,40,173
Vermont8,8,Drew Urquhart,SO,F,Vermont,AEC,33,480,66,147,66,144,0,3,42,64,26,74,100,21,5,18,39,65,174
Vermont9,9,Nate Rohrer,SO,F,Vermont,AEC,30,419,39,65,33,48,6,17,13,22,22,30,52,15,11,4,7,44,97
Vermont10,10,Everett Duncan,FR,G,Vermont,AEC,24,156,13,34,3,4,10,30,5,5,7,19,26,5,3,0,6,21,41
Vermont11,11,Dylan Sinnickson,SR,F,Vermont,AEC,15,74,8,16,5,9,3,7,0,1,11,16,27,1,2,0,3,12,19
Villanova1,1,Ryan Arcidiacono,SR,G,Villanova,Big East,34,1089,134,324,74,157,60,167,75,92,14,90,104,151,47,1,52,50,403
Villanova2,2,Josh Hart,JR,G,Villanova,Big East,34,1072,194,380,144,243,50,137,90,121,66,170,236,63,37,7,52,75,528
Villanova3,3,Kris Jenkins,JR,F,Villanova,Big East,34,968,146,332,63,108,83,224,77,92,17,113,130,70,23,14,41,86,452
Villanova4,4,Jalen Brunson,FR,G,Villanova,Big East,34,820,110,245,68,131,42,114,75,97,16,44,60,89,24,0,66,69,337
Villanova5,5,Phil Booth,SO,G,Villanova,Big East,34,761,73,214,41,103,32,111,56,64,17,60,77,78,22,4,53,65,234
Villanova6,6,Daniel Ochefu,SR,F,Villanova,Big East,31,693,123,201,123,200,0,1,56,83,69,166,235,47,22,47,43,81,302
Villanova7,7,Mikal Bridges,FR,G,Villanova,Big East,34,679,71,141,51,71,20,70,51,65,32,80,112,32,34,24,20,75,213
Villanova8,8,Darryl Reynolds,JR,F,Villanova,Big East,34,606,45,68,45,68,0,0,36,50,41,120,161,13,15,19,25,81,126
Villanova9,9,Donte DiVincenzo,FR,G,Villanova,Big East,8,74,6,21,3,4,3,17,0,0,10,6,16,4,4,0,7,10,15
Villanova10,10,Patrick Farrell,SR,F,Villanova,Big East,12,23,1,4,0,0,1,4,0,0,0,3,3,1,0,0,1,0,3
Villanova11,11,Kevin Rafferty,SR,F,Villanova,Big East,11,20,2,5,2,4,0,1,0,0,1,1,2,0,0,0,3,3,4
Virginia1,1,Malcolm Brogdon,SR,G,Virginia,ACC,33,1122,212,453,140,277,72,176,122,138,16,118,134,94,29,6,48,68,618
Virginia2,2,London Perrantes,JR,G,Virginia,ACC,31,1022,109,247,44,112,65,135,58,72,14,78,92,136,34,3,58,36,341
Virginia3,3,Anthony Gill,SR,F,Virginia,ACC,33,924,162,290,160,288,2,2,112,152,76,125,201,21,19,18,37,76,438
Virginia4,4,Isaiah Wilkins,SO,F,Virginia,ACC,33,714,62,121,62,118,0,3,28,43,49,87,136,46,28,25,24,67,152
Virginia5,5,Devon Hall,SO,G,Virginia,ACC,33,693,53,137,33,81,20,56,24,31,8,76,84,60,16,8,27,45,150
Virginia6,6,Darius Thompson,SO,G,Virginia,ACC,33,609,51,101,39,64,12,37,26,36,8,35,43,50,26,5,29,51,140
Virginia7,7,Mike Tobey,SR,C,Virginia,ACC,33,519,97,167,95,158,2,9,29,47,48,94,142,14,10,17,24,68,225
Virginia8,8,Marial Shayok,SO,G,Virginia,ACC,31,461,48,98,34,65,14,33,12,22,8,47,55,35,11,5,23,49,122
Virginia9,9,Evan Nolte,SR,F,Virginia,ACC,30,263,21,54,11,21,10,33,6,10,7,15,22,11,6,5,9,24,58
Virginia10,10,Jack Salt,FR,C,Virginia,ACC,20,135,16,32,16,32,0,0,1,4,14,10,24,0,1,5,10,25,33
Virginia11,11,Jarred Reuter,FR,F,Virginia,ACC,24,118,16,34,16,34,0,0,8,10,10,15,25,4,1,0,6,24,40
Virginia12,12,Caid Kirven,SR,F,Virginia,ACC,12,17,2,5,1,2,1,3,0,0,1,1,2,0,0,0,1,2,5
Virginia Commonwealth1,1,Melvin Johnson,SR,G,Virginia Commonwealth,A-10,34,1072,210,499,106,232,104,267,69,84,19,71,90,76,44,2,53,45,593
Virginia Commonwealth2,2,Korey Billbury,SR,G,Virginia Commonwealth,A-10,34,961,148,350,106,246,42,104,54,83,54,116,170,42,38,3,44,78,392
Virginia Commonwealth3,3,JeQuan Lewis,JR,G,Virginia Commonwealth,A-10,34,955,118,262,79,166,39,96,90,106,7,74,81,166,53,1,86,95,365
Virginia Commonwealth4,4,Mo Alie-Cox,JR,F,Virginia Commonwealth,A-10,34,901,126,211,126,211,0,0,94,129,85,88,173,36,25,64,50,75,346
Virginia Commonwealth5,5,Justin Tillman,SO,F,Virginia Commonwealth,A-10,34,580,106,176,106,175,0,1,43,74,83,134,217,8,12,17,21,52,255
Virginia Commonwealth6,6,Jordan Burgess,JR,G,Virginia Commonwealth,A-10,26,557,46,133,26,60,20,73,18,34,23,78,101,34,14,11,26,50,130
Virginia Commonwealth7,7,Doug Brooks,JR,G,Virginia Commonwealth,A-10,34,553,41,143,12,37,29,106,32,45,13,72,85,45,66,5,24,92,143
Virginia Commonwealth8,8,Jonathan Williams,SO,G,Virginia Commonwealth,A-10,30,436,46,98,44,89,2,9,26,40,5,34,39,54,23,0,30,48,120
Virginia Commonwealth9,9,Ahmed Hamdy Mohamed,JR,F,Virginia Commonwealth,A-10,34,402,75,149,75,148,0,1,36,68,50,63,113,6,8,19,25,67,186
Virginia Commonwealth10,10,Michael Gilmore,SO,F,Virginia Commonwealth,A-10,29,326,33,74,22,43,11,31,7,15,19,57,76,12,12,7,21,49,84
Virginia Commonwealth11,11,Torey Burston,JR,G,Virginia Commonwealth,A-10,20,66,1,8,1,7,0,1,1,2,2,4,6,5,3,0,1,5,3
Virginia Commonwealth12,12,Gerron Scissum,FR,F,Virginia Commonwealth,A-10,13,29,3,9,3,6,0,3,0,2,5,3,8,1,0,1,0,5,6
Virginia Military Institute1,1,QJ Peterson,JR,G,Virginia Military Institute,Southern,30,1006,189,467,106,237,83,230,134,148,49,140,189,83,42,15,82,67,595
Virginia Military Institute2,2,Julian Eleby,JR,G,Virginia Military Institute,Southern,30,1002,132,306,69,147,63,159,87,107,17,121,138,78,32,6,77,48,414
Virginia Military Institute3,3,Phillip Anglade,SR,F,Virginia Military Institute,Southern,30,768,113,212,113,211,0,1,23,71,77,84,161,16,23,48,31,99,249
Virginia Military Institute4,4,Trey Chapman,JR,F,Virginia Military Institute,Southern,26,671,83,200,66,149,17,51,26,46,40,82,122,26,12,16,43,80,209
Virginia Military Institute5,5,Tim Marshall,SR,G,Virginia Military Institute,Southern,28,600,74,218,23,49,51,169,15,25,12,55,67,31,19,2,34,62,214
Virginia Military Institute6,6,Adrian Rich,FR,G,Virginia Military Institute,Southern,30,586,39,100,34,75,5,25,16,25,4,31,35,45,20,3,48,37,99
Virginia Military Institute7,7,Austin Vereen,FR,G,Virginia Military Institute,Southern,28,445,28,80,14,34,14,46,20,28,11,35,46,16,13,6,25,52,90
Virginia Military Institute8,8,Jordan Weethee,SR,F,Virginia Military Institute,Southern,29,411,35,92,7,13,28,79,8,8,7,50,57,15,7,2,16,55,106
Virginia Military Institute9,9,Fred Iruafemi,SO,F,Virginia Military Institute,Southern,29,344,25,49,25,48,0,1,18,20,22,42,64,17,11,25,11,68,68
Virginia Military Institute10,10,Armani Branch,SO,F,Virginia Military Institute,Southern,16,128,10,39,8,22,2,17,9,14,4,20,24,2,3,2,11,9,31
Virginia Military Institute11,11,Chase Jones,SO,F,Virginia Military Institute,Southern,3,6,1,2,1,1,0,1,0,0,1,0,1,0,1,0,0,0,2
Virginia Tech1,1,Justin Bibbs,SO,G,Virginia Tech,ACC,33,1067,142,296,68,139,74,157,42,57,12,96,108,34,13,0,37,50,400
Virginia Tech2,2,Zach LeDay,JR,F,Virginia Tech,ACC,33,1005,165,346,145,293,20,53,147,189,91,159,250,46,26,51,56,94,497
Virginia Tech3,3,Seth Allen,JR,G,Virginia Tech,ACC,33,924,141,359,99,209,42,150,158,203,9,92,101,83,30,8,98,72,482
Virginia Tech4,4,Justin Robinson,FR,G,Virginia Tech,ACC,33,762,74,168,55,117,19,51,83,113,11,51,62,94,21,4,53,63,250
Virginia Tech5,5,Devin Wilson,JR,G,Virginia Tech,ACC,30,654,20,58,16,40,4,18,17,30,4,50,54,67,22,1,31,66,61
Virginia Tech6,6,Jalen Hudson,SO,G,Virginia Tech,ACC,33,647,87,220,61,147,26,73,61,91,17,50,67,19,20,5,45,63,261
Virginia Tech7,7,Kerry Blackshear Jr.,FR,F,Virginia Tech,ACC,33,632,76,141,72,124,4,17,46,81,55,92,147,18,17,12,31,96,202
Virginia Tech8,8,Chris Clarke,FR,G,Virginia Tech,ACC,20,442,57,128,56,120,1,8,55,83,42,76,118,29,19,1,32,37,170
Virginia Tech9,9,Shane Henry,SR,F,Virginia Tech,ACC,31,281,25,46,25,46,0,0,10,34,16,52,68,2,6,12,12,49,60
Virginia Tech10,10,Johnny Hamilton,JR,C,Virginia Tech,ACC,17,124,13,25,13,25,0,0,5,13,19,18,37,4,0,16,6,16,31
Virginia Tech11,11,Satchel Pierce,SO,F,Virginia Tech,ACC,19,119,12,19,12,19,0,0,8,10,8,16,24,5,3,3,9,27,32
Virginia Tech12,12,Matt Galloway,JR,G,Virginia Tech,ACC,7,35,2,10,1,2,1,8,0,0,2,0,2,1,1,0,2,1,5
Virginia Tech13,13,Greg Donlon,JR,F,Virginia Tech,ACC,6,8,4,6,4,6,0,0,2,2,1,3,4,0,0,0,1,0,10
Wagner1,1,Corey Henson,SO,G,Wagner,NEC,32,969,149,346,76,170,73,176,67,82,21,76,97,95,38,1,53,72,438
Wagner2,2,Michael Carey,JR,G,Wagner,NEC,32,925,142,278,130,229,12,49,106,131,104,196,300,48,24,27,52,79,402
Wagner3,3,Dwaun Anderson,SR,G,Wagner,NEC,31,873,118,271,107,216,11,55,57,82,36,109,145,52,35,28,53,69,304
Wagner4,4,JoJo Cooper,SO,G,Wagner,NEC,32,673,32,120,25,80,7,40,45,68,19,57,76,92,29,5,53,54,116
Wagner5,5,Mike Aaman,SR,F,Wagner,NEC,32,603,103,200,103,200,0,0,51,85,76,98,174,16,14,17,44,87,257
Wagner6,6,Romone Saunders,SO,G,Wagner,NEC,25,585,76,184,37,82,39,102,37,50,26,77,103,50,26,6,40,54,228
Wagner7,7,Henry Brooks,SR,F,Wagner,NEC,32,566,79,182,79,181,0,1,15,26,44,48,92,18,22,25,41,118,173
Wagner8,8,Aaren Edmead,SO,G,Wagner,NEC,30,493,44,129,20,53,24,76,36,43,4,26,30,39,13,3,28,41,148
Wagner9,9,Japhet Kadji,SO,F,Wagner,NEC,26,388,42,121,20,52,22,69,10,14,18,40,58,7,13,6,20,60,116
Wagner10,10,Greg Senat,JR,F,Wagner,NEC,30,259,15,38,15,38,0,0,16,33,37,30,67,4,6,8,18,44,46
Wagner11,11,Devin Liggeons,FR,G,Wagner,NEC,13,61,8,23,6,16,2,7,8,15,10,9,19,2,1,2,3,10,26
Wagner12,12,Bruce Brittingham,SR,G,Wagner,NEC,8,12,1,3,1,1,0,2,0,0,0,4,4,3,0,1,2,0,2
Wake Forest1,1,Bryant Crawford,FR,G,Wake Forest,ACC,30,952,138,350,82,189,56,161,81,121,16,76,92,133,52,7,106,91,413
Wake Forest2,2,Devin Thomas,SR,F,Wake Forest,ACC,29,891,162,299,162,299,0,0,128,219,89,207,296,70,19,46,81,88,452
Wake Forest3,3,Mitchell Wilbekin,SO,G,Wake Forest,ACC,31,875,71,206,21,59,50,147,34,40,9,53,62,42,18,1,18,66,226
Wake Forest4,4,Konstantinos Mitoglou,SO,F,Wake Forest,ACC,31,738,94,220,52,88,42,132,56,73,56,111,167,22,16,24,44,86,286
Wake Forest5,5,Codi Miller-McIntyre,SR,G,Wake Forest,ACC,23,701,81,196,66,150,15,46,40,61,39,64,103,92,18,2,54,62,217
Wake Forest6,6,Cornelius Hudson,SO,F,Wake Forest,ACC,21,485,48,141,26,58,22,83,45,63,11,59,70,29,17,4,40,41,163
Wake Forest7,7,John Collins,FR,F,Wake Forest,ACC,31,446,81,148,81,148,0,0,65,94,51,70,121,7,9,23,31,82,227
Wake Forest8,8,Rondale Watson,SO,G,Wake Forest,ACC,23,343,24,62,15,32,9,30,15,27,5,32,37,22,13,2,16,30,72
Wake Forest9,9,Greg McClinton,SO,F,Wake Forest,ACC,28,301,37,68,37,67,0,1,16,28,25,40,65,7,6,4,17,37,90
Wake Forest10,10,Trent VanHorn,JR,G,Wake Forest,ACC,19,234,8,26,7,15,1,11,13,17,3,13,16,8,8,0,10,20,30
Wake Forest11,11,Doral Moore,FR,C,Wake Forest,ACC,30,213,48,74,48,74,0,0,18,31,36,41,77,1,6,24,27,44,114
Wake Forest12,12,Troy Rike,SO,F,Wake Forest,ACC,5,7,1,2,1,2,0,0,0,0,0,6,6,0,0,0,0,0,2
Washington1,1,Andrew Andrews,SR,G,Washington,Pac-12,32,1082,172,438,97,250,75,188,251,295,50,138,188,154,46,1,88,91,670
Washington2,2,Dejounte Murray,FR,G,Washington,Pac-12,32,1067,184,447,150,333,34,114,96,146,41,144,185,141,57,10,101,86,498
Washington3,3,Marquese Chriss,FR,F,Washington,Pac-12,32,791,162,307,142,250,20,57,78,116,77,91,168,26,29,52,64,130,422
Washington4,4,Matisse Thybulle,FR,F,Washington,Pac-12,32,783,68,170,34,80,34,90,35,49,37,68,105,52,38,31,47,103,205
Washington5,5,Noah Dickerson,FR,F,Washington,Pac-12,32,724,91,195,91,194,0,1,62,99,58,112,170,10,26,21,45,110,244
Washington6,6,David Crisp,FR,G,Washington,Pac-12,32,688,80,243,31,82,49,161,30,45,22,56,78,54,25,4,39,60,239
Washington7,7,Malik Dime,JR,F,Washington,Pac-12,32,688,87,141,87,141,0,0,51,68,79,107,186,3,13,83,27,98,225
Washington8,8,Dominic Green,FR,F,Washington,Pac-12,28,291,23,89,9,31,14,58,6,13,7,23,30,7,4,6,10,20,66
Washington9,9,Donaven Dorsey,SO,F,Washington,Pac-12,25,241,21,54,7,13,14,41,3,7,7,22,29,10,5,0,7,34,59
Washington10,10,Devenir Duruisseau,FR,F,Washington,Pac-12,15,104,7,18,7,15,0,3,10,21,10,13,23,0,2,3,9,26,24
Washington11,11,Dan Kingma,SO,G,Washington,Pac-12,10,30,2,7,2,4,0,3,2,2,1,3,4,4,0,0,4,3,6
Washington12,12,Greg Bowman,FR,F,Washington,Pac-12,8,17,5,7,5,6,0,1,0,1,2,2,4,0,0,0,0,0,10
Washington State1,1,Josh Hawkinson,JR,F,Washington State,Pac-12,29,967,170,313,155,274,15,39,91,117,45,276,321,44,20,31,59,60,446
Washington State2,2,Ike Iroegbu,JR,G,Washington State,Pac-12,31,952,139,307,106,212,33,95,84,109,17,88,105,112,27,3,86,60,395
Washington State3,3,Que Johnson,JR,G,Washington State,Pac-12,31,795,121,292,79,188,42,104,66,86,16,59,75,36,16,5,42,76,350
Washington State4,4,Charles Callison,JR,G,Washington State,Pac-12,27,670,80,205,56,130,24,75,28,42,9,35,44,81,30,3,47,58,212
Washington State5,5,Junior Longrus,SR,F,Washington State,Pac-12,31,449,24,40,24,39,0,1,7,21,26,46,72,19,23,18,25,63,55
Washington State6,6,Conor Clifford,JR,C,Washington State,Pac-12,31,436,89,137,89,137,0,0,33,40,23,42,65,9,1,11,41,73,211
Washington State7,7,Ny Redding,SO,G,Washington State,Pac-12,29,349,11,37,8,24,3,13,11,15,6,25,31,42,7,0,25,42,36
Washington State8,8,Valentine Izundu,JR,C,Washington State,Pac-12,23,342,36,56,36,56,0,0,15,34,27,34,61,6,6,50,19,52,87
Washington State9,9,Derrien King,SO,F,Washington State,Pac-12,26,325,33,96,17,54,16,42,16,23,8,40,48,16,5,4,21,37,98
Washington State10,10,Renard Suggs,JR,G,Washington State,Pac-12,25,314,48,125,30,64,18,61,20,33,8,39,47,24,6,4,24,25,134
Washington State11,11,Brett Boese,SR,F,Washington State,Pac-12,29,297,22,54,8,15,14,39,6,9,10,17,27,7,6,0,9,24,64
Washington State12,12,Viont'e Daniels,FR,G,Washington State,Pac-12,20,213,18,48,5,14,13,34,0,1,6,12,18,14,7,1,12,12,49
Washington State13,13,Robert Franks,FR,F,Washington State,Pac-12,23,191,14,50,8,23,6,27,16,21,8,21,29,9,1,4,13,33,50
Weber State1,1,Jeremy Senglin,JR,G,Weber State,Big Sky,34,1182,209,424,103,185,106,239,94,152,11,109,120,94,23,3,77,62,618
Weber State2,2,Joel Bolomboy,SR,F,Weber State,Big Sky,32,1004,187,322,168,270,19,52,158,225,106,299,405,34,23,39,75,70,551
Weber State3,3,Kyndahl Hill,JR,F,Weber State,Big Sky,34,794,103,167,102,157,1,10,73,97,63,137,200,29,15,36,38,88,280
Weber State4,4,McKay Cannon,FR,G,Weber State,Big Sky,34,713,56,143,17,42,39,101,32,45,9,57,66,91,28,1,51,83,183
Weber State5,5,Zach Braxton,FR,F,Weber State,Big Sky,33,674,86,139,86,139,0,0,56,106,42,94,136,17,9,17,49,81,228
Weber State6,6,Dusty Baker,FR,G,Weber State,Big Sky,33,612,53,139,29,78,24,61,51,63,16,67,83,62,15,4,50,42,181
Weber State7,7,Richaud Gittens,JR,G,Weber State,Big Sky,34,593,49,136,19,49,30,87,17,26,6,66,72,45,22,2,30,47,145
Weber State8,8,Ryan Richardson,SO,G,Weber State,Big Sky,28,570,62,161,14,29,48,132,22,26,4,47,51,36,19,3,34,52,194
Weber State9,9,Cody John,FR,G,Weber State,Big Sky,29,506,49,131,40,74,9,57,26,43,3,44,47,46,9,5,29,39,133
Weber State10,10,Juwan Williams,FR,G,Weber State,Big Sky,20,168,21,45,16,34,5,11,19,25,8,24,32,2,2,5,10,28,66
Weber State11,11,Jeremiah Jefferson,FR,G,Weber State,Big Sky,7,56,8,14,4,5,4,9,0,0,0,4,4,8,1,1,2,2,20
Weber State12,12,Kiko Stavrev,FR,F,Weber State,Big Sky,4,20,1,4,1,2,0,2,0,0,1,1,2,3,0,0,1,2,2
Weber State13,13,J.C. Kennedy,SO,F,Weber State,Big Sky,4,8,2,3,0,0,2,3,2,2,0,0,0,1,1,1,0,1,8
West Virginia1,1,Jevon Carter,SO,G,West Virginia,Big 12,34,943,110,283,66,143,44,140,65,86,25,73,98,112,58,7,54,84,329
West Virginia2,2,Devin Williams,JR,F,West Virginia,Big 12,34,856,151,320,151,320,0,0,150,217,116,199,315,48,24,6,75,88,452
West Virginia3,3,Daxter Miles,SO,G,West Virginia,Big 12,31,772,105,245,65,115,40,130,50,82,24,43,67,42,45,2,42,81,300
West Virginia4,4,Jaysean Paige,SR,G,West Virginia,Big 12,34,763,167,363,124,233,43,130,94,120,54,64,118,42,52,7,53,96,471
West Virginia5,5,Tarik Phillip,JR,G,West Virginia,Big 12,34,757,93,217,57,131,36,86,96,138,22,59,81,96,53,8,65,83,318
West Virginia6,6,Jonathan Holton,SR,F,West Virginia,Big 12,30,695,103,194,93,150,10,44,51,78,112,118,230,44,31,10,36,78,267
West Virginia7,7,Nathan Adrian,JR,F,West Virginia,Big 12,34,618,60,120,38,68,22,52,17,30,52,53,105,32,27,7,27,99,159
West Virginia8,8,Esa Ahmad,FR,F,West Virginia,Big 12,33,599,51,117,49,101,2,16,51,83,36,52,88,49,28,17,47,60,155
West Virginia9,9,Elijah Macon,SO,F,West Virginia,Big 12,34,458,59,113,59,113,0,0,37,80,42,61,103,18,12,15,32,66,155
West Virginia10,10,Teyvon Myers,JR,G,West Virginia,Big 12,28,245,20,58,11,29,9,29,18,23,4,18,22,15,7,0,15,22,67
West Virginia11,11,Brandon Watkins,JR,F,West Virginia,Big 12,22,122,6,17,6,17,0,0,2,6,10,14,24,4,1,6,10,30,14
West Virginia12,12,Richard Romeo,SR,G,West Virginia,Big 12,9,19,2,3,2,3,0,0,2,2,0,2,2,0,0,0,2,5,6
Western Carolina1,1,Mike Brown,SR,G,Western Carolina,Southern,33,1130,184,445,141,314,43,131,153,188,72,120,192,105,48,12,107,109,564
Western Carolina2,2,Justin Browning,SR,F,Western Carolina,Southern,32,1001,111,215,93,155,18,60,72,112,61,130,191,53,71,33,60,111,312
Western Carolina3,3,Torrion Brummitt,SR,F,Western Carolina,Southern,33,920,177,348,170,307,7,41,103,167,65,181,246,46,28,27,96,125,464
Western Carolina4,4,Rhett Harrelson,SR,G,Western Carolina,Southern,29,870,101,248,20,58,81,190,62,73,11,42,53,58,23,0,41,51,345
Western Carolina5,5,Devin Peterson,SO,G,Western Carolina,Southern,33,672,60,170,47,107,13,63,33,49,13,45,58,50,29,3,47,66,166
Western Carolina6,6,Marc Gosselin,FR,F,Western Carolina,Southern,32,598,37,81,31,59,6,22,19,30,48,77,125,28,13,5,29,78,99
Western Carolina7,7,Elijah Pughsley,FR,G,Western Carolina,Southern,25,524,68,201,16,57,52,144,44,60,9,34,43,34,24,1,54,42,232
Western Carolina8,8,Haboubacar Mutombo,SO,G,Western Carolina,Southern,31,502,52,103,44,82,8,21,10,17,37,57,94,19,15,7,9,35,122
Western Carolina9,9,Jesse Deloach,FR,F,Western Carolina,Southern,29,189,9,29,9,28,0,1,4,15,9,43,52,2,5,16,8,23,22
Western Carolina10,10,Ashley Williams,SO,F,Western Carolina,Southern,15,111,8,26,7,18,1,8,6,10,7,7,14,6,3,3,2,9,23
Western Carolina11,11,Deriece Parks,JR,G,Western Carolina,Southern,9,99,6,31,4,10,2,21,5,8,6,7,13,8,5,1,3,4,19
Western Carolina12,12,Charlendez Brooks,SO,F,Western Carolina,Southern,11,75,5,12,5,12,0,0,1,2,4,6,10,4,1,1,4,19,11
Western Carolina13,13,Aaron Williams,SO,G,Western Carolina,Southern,5,18,4,5,2,2,2,3,5,5,1,1,2,0,0,0,0,0,15
Western Carolina14,14,Kyle Rhoades,JR,F,Western Carolina,Southern,3,13,3,4,3,4,0,0,0,0,2,7,9,0,0,0,1,4,6
Western Carolina15,15,Devonte Fuller,FR,G,Western Carolina,Southern,2,3,2,4,1,3,1,1,0,0,2,0,2,0,0,0,1,1,5
Western Illinois1,1,Garret Covington,JR,G,Western Illinois,Summit,27,911,159,358,82,176,77,182,88,111,12,99,111,53,23,5,59,47,483
Western Illinois2,2,Jabari Sandifer,JR,G,Western Illinois,Summit,27,880,71,187,51,132,20,55,66,91,14,97,111,128,48,4,63,72,228
Western Illinois3,3,J.C. Fuller,SR,G,Western Illinois,Summit,27,783,123,310,86,205,37,105,59,67,24,97,121,51,17,9,51,50,342
Western Illinois4,4,Tate Stensgaard,SR,F,Western Illinois,Summit,25,596,84,139,84,139,0,0,48,70,45,90,135,20,8,14,32,86,216
Western Illinois5,5,Jalen Chapman,SR,F,Western Illinois,Summit,27,472,77,155,77,155,0,0,44,71,28,66,94,13,23,20,31,80,198
Western Illinois6,6,Mike Miklusak,JR,F,Western Illinois,Summit,23,398,41,88,15,31,26,57,14,22,15,60,75,21,10,6,21,36,122
Western Illinois7,7,Brandon Gilbeck,FR,C,Western Illinois,Summit,27,393,35,79,35,79,0,0,6,16,30,68,98,18,5,22,24,76,76
Western Illinois8,8,De'Angelo Bruster,FR,G,Western Illinois,Summit,26,296,14,44,6,22,8,22,12,17,9,26,35,33,10,0,26,34,48
Western Illinois9,9,Jamie Batish,SR,G,Western Illinois,Summit,22,247,20,56,1,5,19,51,0,2,0,13,13,5,5,1,1,15,59
Western Illinois10,10,Jalen Morgan,SO,F,Western Illinois,Summit,25,241,30,53,30,52,0,1,14,21,15,33,48,6,7,4,13,41,74
Western Illinois11,11,Dalan Ancrum,SO,G,Western Illinois,Summit,14,122,16,32,14,21,2,11,9,12,9,15,24,11,5,2,5,15,43
Western Illinois12,12,James Claar,FR,F,Western Illinois,Summit,7,21,3,6,3,6,0,0,0,0,2,2,4,0,0,2,1,1,6
Western Illinois13,13,Ryan Maas,FR,G,Western Illinois,Summit,3,9,1,4,1,3,0,1,0,0,0,2,2,0,0,0,0,0,2
Western Illinois14,14,Noah Wells,FR,G,Western Illinois,Summit,3,9,2,4,1,2,1,2,0,0,1,4,5,0,1,0,0,0,5
Western Kentucky1,1,Aaron Cosby,SR,G,Western Kentucky,CUSA,34,1073,136,389,55,168,81,221,112,131,16,108,124,67,15,5,67,47,465
Western Kentucky2,2,Justin Johnson,SO,F,Western Kentucky,CUSA,34,984,197,328,196,319,1,9,112,166,102,168,270,48,16,19,58,73,507
Western Kentucky3,3,Fredrick Edmond,JR,G,Western Kentucky,CUSA,33,954,163,285,155,264,8,21,68,125,38,158,196,90,33,15,72,53,402
Western Kentucky4,4,Chris McNeal,FR,G,Western Kentucky,CUSA,34,952,58,179,24,60,34,119,42,61,21,114,135,134,19,1,67,61,192
Western Kentucky5,5,Nigel Snipes,SR,F,Western Kentucky,CUSA,34,728,100,222,38,85,62,137,37,51,21,64,85,37,21,11,47,90,299
Western Kentucky6,6,Ben Lawson,JR,F,Western Kentucky,CUSA,34,547,57,96,56,95,1,1,56,73,37,75,112,13,11,65,37,91,171
Western Kentucky7,7,Anton Waters,JR,F,Western Kentucky,CUSA,33,480,58,111,58,109,0,2,30,43,57,74,131,7,3,10,26,65,146
Western Kentucky8,8,Chris Harrison-Docks,JR,G,Western Kentucky,CUSA,18,431,58,148,20,48,38,100,26,33,3,15,18,35,8,0,19,25,180
Western Kentucky9,9,Marlon Hunter,FR,G,Western Kentucky,CUSA,32,390,53,122,50,111,3,11,27,40,27,31,58,13,24,2,17,37,136
Western Kentucky10,10,Aleksej Rostov,SR,F,Western Kentucky,CUSA,33,345,43,85,38,64,5,21,22,39,30,42,72,16,1,11,17,62,113
Western Kentucky11,11,Dylan Sanford,FR,G,Western Kentucky,CUSA,5,13,2,2,2,2,0,0,0,0,1,0,1,0,0,0,4,2,4
Western Michigan1,1,Tucker Haymond,JR,G,Western Michigan,MAC,32,1019,169,398,137,275,32,123,139,196,61,125,186,73,21,1,74,70,509
Western Michigan2,2,Thomas Wilder,SO,G,Western Michigan,MAC,32,1018,172,405,127,290,45,115,188,238,21,113,134,98,52,4,66,85,577
Western Michigan3,3,A.J. Avery,SR,F,Western Michigan,MAC,32,786,85,173,81,164,4,9,62,91,68,122,190,22,23,22,34,105,236
Western Michigan4,4,Drake LaMont,SO,C,Western Michigan,MAC,32,751,103,193,103,192,0,1,44,65,61,85,146,36,16,20,34,83,250
Western Michigan5,5,Taylor Perry,SR,G,Western Michigan,MAC,32,701,37,112,24,69,13,43,29,38,18,83,101,38,19,7,37,53,116
Western Michigan6,6,Bryce Moore,FR,G,Western Michigan,MAC,31,660,53,145,31,80,22,65,41,56,11,57,68,41,19,2,46,62,169
Western Michigan7,7,Seth Dugan,FR,C,Western Michigan,MAC,32,514,61,128,61,128,0,0,32,60,47,85,132,29,3,20,43,72,154
Western Michigan8,8,Kellen McCormick,JR,F,Western Michigan,MAC,32,475,64,134,15,27,49,107,15,22,11,51,62,19,5,1,23,44,192
Western Michigan9,9,Jared Klein,SR,G,Western Michigan,MAC,30,356,22,61,3,9,19,52,6,9,2,26,28,18,13,0,9,21,69
Western Michigan10,10,Josh Davis,FR,G,Western Michigan,MAC,25,270,20,75,7,21,13,54,17,30,3,33,36,8,12,3,24,38,70
Wichita State1,1,Ron Baker,SR,G,Wichita State,MVC,32,1004,147,341,88,176,59,165,100,127,17,135,152,102,49,21,48,46,453
Wichita State2,2,Fred VanVleet,SR,G,Wichita State,MVC,28,797,104,265,64,168,40,97,89,109,8,80,88,159,44,3,48,49,337
Wichita State3,3,Evan Wessel,SR,G,Wichita State,MVC,32,703,42,129,14,27,28,102,7,15,47,54,101,24,17,2,13,57,119
Wichita State4,4,Zach Brown,SO,F,Wichita State,MVC,32,618,69,150,45,70,24,80,65,92,37,58,95,32,27,13,36,71,227
Wichita State5,5,Markis McDuffie,FR,F,Wichita State,MVC,31,561,78,181,57,113,21,68,49,68,30,67,97,25,22,7,27,49,226
Wichita State6,6,Rashard Kelly,SO,F,Wichita State,MVC,32,510,53,117,47,100,6,17,24,39,44,75,119,25,15,5,24,62,136
Wichita State7,7,Anton Grady,SR,F,Wichita State,MVC,28,485,85,161,84,153,1,8,52,88,37,93,130,10,13,20,44,77,223
Wichita State8,8,Shaquille Morris,SO,F,Wichita State,MVC,31,472,83,144,83,144,0,0,41,62,37,68,105,13,9,32,22,84,207
Wichita State9,9,Conner Frankamp,SO,G,Wichita State,MVC,25,440,52,135,21,44,31,91,17,20,3,36,39,25,9,3,4,22,152
Wichita State10,10,Bush Wamukota,SR,C,Wichita State,MVC,26,186,13,28,13,27,0,1,7,8,16,26,42,3,6,1,6,39,33
Wichita State11,11,Rauno Nurger,SO,C,Wichita State,MVC,25,179,14,34,13,24,1,10,8,14,10,19,29,2,2,6,6,31,37
Wichita State12,12,Ty Taylor II,FR,G,Wichita State,MVC,20,153,21,72,11,40,10,32,7,8,5,12,17,11,7,0,10,17,59
Wichita State13,13,Eric Hamilton,FR,F,Wichita State,MVC,21,136,23,44,19,33,4,11,21,32,10,25,35,2,1,4,9,15,71
Wichita State14,14,John Robert Simon,JR,G,Wichita State,MVC,24,116,9,23,3,8,6,15,8,12,3,5,8,18,3,0,7,13,32
Wichita State15,15,Landry Shamet,FR,G,Wichita State,MVC,3,53,7,16,4,6,3,10,9,12,3,5,8,5,5,1,2,8,26
Wichita State16,16,Zach Bush,JR,F,Wichita State,MVC,17,37,1,6,1,3,0,3,3,4,1,3,4,4,2,0,0,4,5
William & Mary1,1,Omar Prewitt,JR,G,William & Mary,CAA,31,998,188,381,145,263,43,118,133,189,26,136,162,77,24,16,59,71,552
William & Mary2,2,David Cohn,SO,G,William & Mary,CAA,31,923,92,213,64,138,28,75,86,103,18,80,98,144,26,3,50,42,298
William & Mary3,3,Terry Tarpey,SR,G,William & Mary,CAA,30,905,113,232,97,170,16,62,71,90,42,191,233,75,62,39,55,57,313
William & Mary4,4,Daniel Dixon,JR,G,William & Mary,CAA,30,890,132,328,62,131,70,197,42,58,9,106,115,54,14,20,43,60,376
William & Mary5,5,Sean Sheldon,SR,F,William & Mary,CAA,31,775,108,173,108,173,0,0,46,70,52,97,149,52,5,15,34,80,262
William & Mary6,6,Greg Malinowski,SO,G,William & Mary,CAA,31,582,83,193,48,88,35,105,38,53,27,92,119,24,18,8,22,52,239
William & Mary7,7,Connor Burchfield,SO,G,William & Mary,CAA,31,371,59,100,19,29,40,71,10,11,1,43,44,15,5,0,18,22,168
William & Mary8,8,Jack Whitman,SO,F,William & Mary,CAA,23,299,30,55,30,55,0,0,17,32,24,39,63,10,4,19,14,60,77
William & Mary9,9,Oliver Tot,SO,G,William & Mary,CAA,26,171,10,21,6,12,4,9,4,8,2,21,23,22,8,5,12,24,28
William & Mary10,10,Hunter Seacat,FR,F,William & Mary,CAA,19,166,17,28,17,28,0,0,6,12,9,11,20,8,1,5,8,21,40
William & Mary11,11,Michael Schlotman,SO,G,William & Mary,CAA,18,130,3,13,2,9,1,4,4,8,3,14,17,17,3,2,9,17,11
William & Mary12,12,Paul Rowley,FR,F,William & Mary,CAA,8,22,3,9,1,1,2,8,0,0,1,2,3,2,0,0,0,4,8
William & Mary13,13,Jamison Glover,SO,G,William & Mary,CAA,9,19,5,9,3,6,2,3,0,2,0,1,1,1,0,0,1,2,12
Winthrop1,1,Keon Johnson,JR,G,Winthrop,Big South,32,1100,178,394,100,196,78,198,165,198,17,116,133,81,29,0,69,62,599
Winthrop2,2,Jimmy Gavin,SR,G,Winthrop,Big South,32,1080,196,410,102,181,94,229,111,134,16,78,94,95,26,2,66,57,597
Winthrop3,3,Bjorn Broman,FR,G,Winthrop,Big South,32,903,54,171,11,36,43,135,41,49,12,50,62,62,24,0,29,64,192
Winthrop4,4,Xavier Cooks,SO,F,Winthrop,Big South,32,883,172,332,133,233,39,99,88,115,47,179,226,57,26,54,83,84,471
Winthrop5,5,Josh Davenport,JR,F,Winthrop,Big South,32,624,70,117,66,107,4,10,48,71,25,110,135,41,25,16,37,77,192
Winthrop6,6,Zach Price,SR,C,Winthrop,Big South,32,601,74,143,74,143,0,0,47,78,55,97,152,5,10,19,38,98,195
Winthrop7,7,Duby Okeke,SO,C,Winthrop,Big South,29,496,57,89,57,89,0,0,29,59,49,90,139,5,8,72,31,70,143
Winthrop8,8,Roderick Perkins,JR,F,Winthrop,Big South,15,264,32,97,18,46,14,51,12,16,14,26,40,14,7,6,13,25,90
Winthrop9,9,Adam Pickett,FR,G,Winthrop,Big South,30,210,33,57,31,47,2,10,20,24,11,26,37,9,13,6,17,32,88
Winthrop10,10,Jarad Scott,JR,F,Winthrop,Big South,19,128,15,33,6,9,9,24,4,6,3,25,28,5,1,0,10,25,43
Winthrop11,11,Freddy Poole,SO,F,Winthrop,Big South,12,34,1,4,1,3,0,1,1,5,0,5,5,0,3,0,1,5,3
Winthrop12,12,Hunter Sadlon,JR,G,Winthrop,Big South,12,31,1,6,1,4,0,2,0,0,1,2,3,2,1,0,1,2,2
Winthrop13,13,Mitch Hill,SO,F,Winthrop,Big South,9,25,2,8,2,3,0,5,0,0,0,3,3,2,0,0,1,0,4
Winthrop14,14,Kellen Blake,SO,G,Winthrop,Big South,9,21,5,8,3,4,2,4,0,1,1,0,1,0,1,0,1,1,12
Wisconsin1,1,Nigel Hayes,JR,F,Wisconsin,Big Ten,32,1160,152,399,115,281,37,118,181,244,66,119,185,96,36,13,72,65,522
Wisconsin2,2,Bronson Koenig,JR,G,Wisconsin,Big Ten,32,1111,141,350,65,157,76,193,71,93,11,69,80,81,10,6,48,73,429
Wisconsin3,3,Zak Showalter,JR,G,Wisconsin,Big Ten,32,1003,81,175,46,77,35,98,45,56,24,100,124,71,33,6,42,94,242
Wisconsin4,4,Ethan Happ,FR,F,Wisconsin,Big Ten,32,893,144,273,144,273,0,0,99,154,77,173,250,39,58,29,67,96,387
Wisconsin5,5,Vitto Brown,JR,F,Wisconsin,Big Ten,32,804,118,268,87,189,31,79,42,55,59,106,165,25,19,17,36,77,309
Wisconsin6,6,Jordan Hill,SO,G,Wisconsin,Big Ten,27,413,31,79,14,31,17,48,4,6,11,24,35,21,8,1,17,39,83
Wisconsin7,7,Khalil Iverson,FR,F,Wisconsin,Big Ten,31,413,31,66,29,54,2,12,19,34,22,37,59,20,11,15,29,27,83
Wisconsin8,8,Alex Illikainen,FR,F,Wisconsin,Big Ten,30,305,25,60,16,33,9,27,10,15,15,31,46,13,5,3,10,31,69
Wisconsin9,9,Charlie Thomas,FR,F,Wisconsin,Big Ten,28,272,26,70,22,57,4,13,14,30,20,37,57,3,6,11,5,32,70
Wisconsin10,10,Aaron Moesch,SO,F,Wisconsin,Big Ten,15,48,1,2,1,2,0,0,2,2,2,3,5,1,2,0,1,4,4
Wisconsin11,11,Jordan Smith,SR,G,Wisconsin,Big Ten,8,9,1,3,1,3,0,0,2,3,1,1,2,0,0,1,1,0,4
Wofford1,1,Spencer Collins,SR,G,Wofford,Southern,32,1006,152,385,77,202,75,183,94,116,29,78,107,69,27,4,60,75,473
Wofford2,2,Eric Garcia,JR,G,Wofford,Southern,32,981,90,214,33,79,57,135,91,116,10,73,83,153,17,0,47,66,328
Wofford3,3,C.J. Neumann,SR,F,Wofford,Southern,32,940,59,117,59,115,0,2,46,64,65,160,225,38,25,10,36,77,164
Wofford4,4,Fletcher Magee,FR,G,Wofford,Southern,32,921,133,282,42,92,91,190,86,93,12,85,97,47,12,3,47,49,443
Wofford5,5,Justin Gordon,SR,F,Wofford,Southern,32,812,141,290,135,273,6,17,84,142,49,84,133,63,18,17,82,95,372
Wofford6,6,Ryan Sawvell,JR,F,Wofford,Southern,31,455,61,103,59,96,2,7,22,29,31,73,104,17,5,4,13,39,146
Wofford7,7,Jaylen Allen,JR,G,Wofford,Southern,30,445,52,149,26,63,26,86,12,27,15,39,54,26,25,3,24,56,142
Wofford8,8,Derrick Brooks,SO,G,Wofford,Southern,32,379,21,58,15,40,6,18,19,23,2,40,42,38,20,2,30,44,67
Wofford9,9,Matthew Pegram,FR,C,Wofford,Southern,30,244,25,54,25,54,0,0,12,13,13,26,39,2,2,11,12,60,62
Wofford10,10,Trevor Stumpe,FR,G,Wofford,Southern,17,108,16,31,11,16,5,15,7,7,2,7,9,6,2,0,2,16,44
Wofford11,11,Cameron Jackson,SO,F,Wofford,Southern,7,100,11,22,11,21,0,1,6,9,11,16,27,2,8,2,5,23,28
Wofford12,12,Zach Korkowski,SR,F,Wofford,Southern,13,38,6,6,6,6,0,0,5,5,4,5,9,5,2,0,3,7,17
Wofford13,13,Bobby Perez,SO,G,Wofford,Southern,9,21,2,4,2,4,0,0,0,1,0,0,0,3,0,0,2,1,4
Wofford14,14,Eric Wagenlander,JR,G,Wofford,Southern,7,13,2,4,0,0,2,4,0,0,0,4,4,1,0,0,1,0,6
Wright State1,1,Joe Thomasson,SR,G,Wright State,Horizon,35,1044,105,246,73,155,32,91,95,116,18,167,185,117,29,16,74,96,337
Wright State2,2,JT Yoho,SR,F,Wright State,Horizon,34,1034,163,369,112,240,51,129,50,71,21,147,168,83,18,2,74,81,427
Wright State3,3,Mark Alstork,SO,G,Wright State,Horizon,35,931,140,324,86,181,54,143,100,144,23,141,164,61,29,21,55,100,434
Wright State4,4,Grant Benzinger,SO,G,Wright State,Horizon,34,896,89,218,27,59,62,159,19,23,9,54,63,18,16,2,20,89,259
Wright State5,5,Biggie Minnis,SR,G,Wright State,Horizon,29,660,86,174,80,152,6,22,26,57,19,66,85,94,26,6,49,77,204
Wright State6,6,Michael Karena,SR,C,Wright State,Horizon,34,657,132,251,132,251,0,0,74,110,50,77,127,11,11,9,48,108,338
Wright State7,7,Mark Hughes,FR,G,Wright State,Horizon,33,636,37,88,19,36,18,52,24,33,9,54,63,41,22,6,17,68,116
Wright State8,8,Justin Mitchell,SO,G,Wright State,Horizon,23,299,31,69,31,66,0,3,11,16,15,38,53,27,22,1,16,34,73
Wright State9,9,Parker Ernsthausen,FR,F,Wright State,Horizon,32,290,16,36,16,35,0,1,22,33,19,28,47,2,10,2,10,58,54
Wright State10,10,Alan Vest,FR,G,Wright State,Horizon,21,214,11,28,4,10,7,18,3,5,1,14,15,8,2,1,8,15,32
Wright State11,11,Daniel Mortensen,FR,F,Wright State,Horizon,22,139,21,52,3,8,18,44,0,0,2,15,17,5,1,3,5,17,60
Wright State12,12,Daniel Collie,SR,G,Wright State,Horizon,17,84,5,17,2,6,3,11,2,3,0,2,2,6,2,1,1,8,15
Wright State13,13,Brandon Neel,JR,G,Wright State,Horizon,5,58,6,19,6,15,0,4,3,4,4,3,7,1,4,3,2,4,15
Wright State14,14,Roderick Davis,SO,F,Wright State,Horizon,12,50,8,15,8,14,0,1,2,6,3,6,9,2,0,2,5,13,18
Wright State15,15,Trey Stacey,SO,G,Wright State,Horizon,14,33,6,10,1,1,5,9,0,0,1,4,5,2,1,0,1,2,17
Wyoming1,1,Josh Adams,SR,G,Wyoming,MWC,31,1125,220,498,122,239,98,259,211,257,18,155,173,134,44,18,115,86,749
Wyoming2,2,Jason McManamen,JR,G,Wyoming,MWC,32,1107,140,302,44,87,96,215,85,112,10,87,97,49,13,3,41,88,461
Wyoming3,3,Alan Herndon,SO,F,Wyoming,MWC,32,898,91,175,74,119,17,56,49,80,27,123,150,37,18,27,35,81,248
Wyoming4,4,Jeremy Lieberman,SO,G,Wyoming,MWC,32,677,41,124,14,45,27,79,17,22,10,59,69,43,11,0,35,57,126
Wyoming5,5,Alexander Aka Gorski,SO,G,Wyoming,MWC,32,600,54,135,17,39,37,96,48,67,12,50,62,34,7,0,27,60,193
Wyoming6,6,Justin James,FR,G,Wyoming,MWC,31,516,59,141,40,86,19,55,31,55,11,55,66,25,10,11,23,47,168
Wyoming7,7,Trey Washington III,SO,G,Wyoming,MWC,27,515,28,86,15,30,13,56,17,25,6,51,57,35,13,0,19,44,86
Wyoming8,8,Hayden Dalton,SO,F,Wyoming,MWC,29,428,32,76,22,40,10,36,36,46,14,81,95,29,8,13,25,51,110
Wyoming9,9,Jonathan Barnes,SO,C,Wyoming,MWC,29,300,21,42,21,42,0,0,20,41,14,34,48,6,3,6,12,39,62
Wyoming10,10,Jordan Naughton,FR,F,Wyoming,MWC,24,270,26,33,26,33,0,0,20,41,19,27,46,0,5,6,10,37,72
Wyoming11,11,Morris Marshall,JR,G,Wyoming,MWC,9,39,8,14,6,9,2,5,1,1,2,5,7,0,0,0,3,4,19
Xavier1,1,Trevon Bluiett,SO,G,Xavier,Big East,32,976,163,380,88,192,75,188,94,122,48,150,198,74,30,11,54,76,495
Xavier2,2,Myles Davis,JR,G,Xavier,Big East,32,935,106,262,43,99,63,163,80,94,17,98,115,133,31,5,60,67,355
Xavier3,3,Remy Abell,SR,G,Xavier,Big East,32,762,62,157,39,86,23,71,47,61,11,40,51,49,15,2,34,42,194
Xavier4,4,Edmond Sumner,FR,G,Xavier,Big East,29,741,97,238,72,159,25,79,109,147,16,82,98,101,36,6,59,67,328
Xavier5,5,J.P. Macura,SO,G,Xavier,Big East,32,730,103,221,68,121,35,100,67,83,47,39,86,66,35,1,34,79,308
Xavier6,6,James Farr,SR,F,Xavier,Big East,32,662,137,248,136,240,1,8,69,96,90,160,250,17,26,31,43,78,344
Xavier7,7,Jalen Reynolds,JR,F,Xavier,Big East,32,626,115,227,113,221,2,6,69,105,65,141,206,24,22,22,49,98,301
Xavier8,8,Larry Austin,SO,G,Xavier,Big East,32,332,21,52,21,51,0,1,20,32,8,29,37,39,19,0,26,40,62
Xavier9,9,Kaiser Gates,FR,F,Xavier,Big East,28,294,26,64,14,26,12,38,24,42,22,53,75,5,9,7,13,47,88
Xavier10,10,Sean O'Mara,SO,F,Xavier,Big East,30,217,37,62,37,62,0,0,24,40,18,39,57,8,6,7,17,35,98
Xavier11,11,Makinde London,FR,F,Xavier,Big East,18,95,9,25,2,7,7,18,4,8,8,15,23,7,5,5,9,13,29
Yale1,1,Makai Mason,SO,G,Yale,Ivy,28,902,150,346,97,205,53,141,89,113,14,59,73,104,25,2,85,49,442
Yale2,2,Justin Sears,SR,F,Yale,Ivy,26,808,151,291,147,277,4,14,104,156,95,100,195,74,21,46,62,71,410
Yale3,3,Nick Victor,SR,G,Yale,Ivy,28,774,70,140,39,74,31,66,24,44,43,160,203,72,20,35,52,84,195
Yale4,4,Brandon Sherrod,SR,F,Yale,Ivy,28,772,124,221,124,220,0,1,101,172,79,119,198,34,19,19,36,66,349
Yale5,5,Jack Montague,SR,G,Yale,Ivy,20,567,60,162,13,44,47,118,26,31,9,40,49,59,22,0,41,39,193
Yale6,6,Anthony Dallier,JR,G,Yale,Ivy,28,534,47,108,31,65,16,43,22,38,13,73,86,33,23,5,28,53,132
Yale7,7,Sam Downey,JR,F,Yale,Ivy,28,410,61,100,58,91,3,9,32,39,33,61,94,10,5,7,12,48,157
Yale8,8,Khaliq Ghani,SR,G,Yale,Ivy,24,274,22,61,7,18,15,43,6,8,4,35,39,10,8,5,11,26,65
Yale9,9,Blake Reynolds,FR,F,Yale,Ivy,23,163,18,40,14,24,4,16,10,14,14,23,37,8,6,1,6,12,50
Yale10,10,Eric Anderson,SO,G,Yale,Ivy,21,156,16,38,13,29,3,9,6,11,7,20,27,5,5,2,9,14,41
Yale11,11,Trey Phills,FR,G,Yale,Ivy,17,108,7,26,6,16,1,10,6,8,4,11,15,6,3,4,12,17,21
Yale12,12,Alex Copeland,FR,G,Yale,Ivy,14,59,11,23,9,20,2,3,6,10,3,6,9,6,3,1,3,5,30
Yale13,13,A.J. Edwards,JR,G,Yale,Ivy,13,37,2,7,1,1,1,6,0,0,1,1,2,1,1,0,3,1,5
Yale14,14,Matt Greene,FR,F,Yale,Ivy,8,29,3,6,3,6,0,0,1,6,4,3,7,2,1,1,3,9,7
Yale15,15,Thomas Ryan,FR,G,Yale,Ivy,8,22,1,7,0,2,1,5,2,3,1,2,3,0,1,0,0,1,5
Yale16,16,Eli Lininger,FR,F,Yale,Ivy,3,10,1,3,1,3,0,0,1,4,3,1,4,1,0,0,1,2,3
Youngstown State1,1,Matt Donlan,JR,F,Youngstown State,Horizon,32,1109,148,320,66,143,82,177,42,50,12,132,144,42,17,7,47,59,420
Youngstown State2,2,Francisco Santiago,SO,G,Youngstown State,Horizon,32,1006,105,278,83,192,22,86,58,78,20,110,130,139,44,8,74,54,290
Youngstown State3,3,Cameron Morse,SO,G,Youngstown State,Horizon,30,1006,201,427,137,272,64,155,142,175,10,72,82,92,46,2,52,47,608
Youngstown State4,4,Jordan Andrews,FR,G,Youngstown State,Horizon,32,666,77,219,27,83,50,136,48,65,21,69,90,30,28,3,45,81,252
Youngstown State5,5,Brett Frantz,JR,G,Youngstown State,Horizon,32,525,37,116,13,28,24,88,7,10,15,35,50,34,18,1,19,46,105
Youngstown State6,6,Jorden Kaufman,JR,C,Youngstown State,Horizon,29,490,79,148,79,148,0,0,25,48,52,97,149,24,8,16,29,78,183
Youngstown State7,7,Sidney Umude,SO,F,Youngstown State,Horizon,27,469,76,173,76,173,0,0,41,62,33,50,83,20,17,12,33,74,193
Youngstown State8,8,Latin Davis,FR,G,Youngstown State,Horizon,32,417,37,97,27,65,10,32,19,30,12,46,58,40,19,0,22,34,103
Youngstown State9,9,Bobby Hain,SR,F,Youngstown State,Horizon,13,368,63,136,59,113,4,23,31,45,25,57,82,32,6,6,23,30,161
Youngstown State10,10,Bryce Nickels,FR,F,Youngstown State,Horizon,23,319,36,79,36,77,0,2,17,38,24,53,77,11,11,17,28,41,89
Youngstown State11,11,Devin Haygood,FR,F,Youngstown State,Horizon,17,104,9,21,9,21,0,0,10,18,9,13,22,1,4,8,6,26,28
Youngstown State12,12,Ryan Strollo,SO,G,Youngstown State,Horizon,11,37,1,2,0,0,1,2,0,0,0,6,6,1,1,0,1,1,3
Youngstown State13,13,Tyler Warford,JR,G,Youngstown State,Horizon,4,9,1,5,1,2,0,3,0,0,0,0,0,1,0,0,0,0,2